확인=確認する
비행기표=航空券
완복 비행기표=往復航空券
편도 비행기표=片道航空券
웨이팅=空席待ち
일등석=ファーストクラス
비즈니스 클래스=ビジネスクラス
이코노미 클래스=エコノミークラス
흡연석=喫煙席
금연석=禁煙席
통로=通路
창가=窓際
탑승구=ゲート搭乗
탑승권=搭乗券
여권=パスポート
입국신청=入国申請
비자=ビザ
재입국=再入国
스튜어디스=スチュワーデス
구튜어드=救命胴衣
비상구=非常口
산소마스크=酸素マスク
이륙하다=離陸
착륙하다=着陸
좌석 번호=座席番号
비행기멀미=飛行機酔い
구토주머니=嘔吐物バッグ
몸이 불편하다=不快に
두통약=頭痛薬
위장약=胃腸薬
진통제=鎮痛剤
안전벨트=安全ベルト
메다=留める
풀다=ほどく
담요=ウール毛布
베개=枕
식판=ディナープレート
식기=食器
목마르다=のどの渇き
음료수=飲物
주스=フルーツジュース
사이다=ソフトドリンク
끓인 물=飲み水
잡지=雑誌
신문=新聞
이어폰=ヘッドフォン
신고하다=宣言
시간표=時刻表
분실물센터=遺失物センター
매점=売店
