확인=确认
비행기표=机票
완복 비행기표=来回机票
편도 비행기표=单程机票
웨이팅=候补
일등석=头等舱
비즈니스 클래스=商务舱
이코노미 클래스=经济舱
흡연석=吸烟座位
금연석=禁烟座位
통로=走道
창가=靠窗
탑승구=登机门
탑승권=登机证
여권=护照
입국신청=入境申请
비자=签证
재입국=再入境
스튜어디스=空中小姐
구튜어드=救生衣
비상구=紧急出口
산소마스크=氧气罩
이륙하다=起飞
착륙하다=降落
좌석 번호=座位号码
비행기멀미=晕机
구토주머니=呕吐袋
몸이 불편하다=不舒服
두통약=头痛药
위장약=胃药
진통제=止痛药
안전벨트=安全带
메다=系上
풀다=解开
담요=毛毯
베개=枕头
식판=餐盘
식기=餐具
목마르다=口渴
음료수=饮料
주스=果汁
사이다=汽水
끓인 물=白开水
잡지=杂志
신문=报纸
이어폰=耳机
신고하다=申报
시간표=时刻表
분실물센터=遗失物品中心
매점=贩卖处
