가격=n.price
가구=n.furniture
가방=n.bag
가을=n.fall, autumn
가족=n.family
값=n.price
강=n.river
거리=n.distance
걱정=n.anxiety; worry
결혼식=n.wedding
경주=n.race
경험=n.experience
계절=n.season
계획=n.plan
고민=n.worry; agony
고양이=n.cat
고향=n.hometown
곳=n.place
공연=n.performance
공원=n.park
공책=n.note book
공항=n.airport
과일=n.fruit
과자=n.snack
관심=n.interest
교통사고=n.car accident
구두=n.dress shoe
구입=n.purchase
그림=n.picture
극장=n.theater
근처=n.near
글자=n.letter
금년=n.this year
기간=n.period
기분=n.standard
김치=n.kimchi
까만색=n.black
꽃=n.flower
꽃집=n.flower shop
나라=n.country
나무=n.tree
날=n.day
날씨=n.weather
남산=n.Namsan
내년=n.next year
내용=n.content
내일=n.tomorrow
냉면=n.cold noodle
냉장고=n.refrigerator
년=n.year
노래=n.song
누나=n.male's older sister
눈물=n.tear
느낌=n.feeling;
다음=n.next
다음달=n.next month
단어=n.word
달=n.month
댁=n.home
도서관=n.library
돈=n.money
동대문=n.Dongdaemun
동생=n.younger sibling
뒤=n.back
드라마=n.drama
등산=n.hike
등산화=n.hiking shoes
라디오=n.radio
러시아=n.Russia
맞은편=n.across from
머리=n.head
모습=n.figure
모자=n.hat
무게=n.weight
문=n.door
문구점=n.stationary store
문제=n.problem; question; issue
문화=n.culture
물건=n.thing
미국=n.The USA
밑=n.bottom
바지=n.pants
박물관=n.museum
밖=n.outside
반수업=n.class
방=n.room
방법=n.method
방송국=n.broadcasting station
배=n.ship
배2=n.pear
배우=n.actor
백화점=n.department store
버스=n.bus
번호=n.number
병원=n.hospital
볼펜=n.ball point pen
봄=n.spring
부모=n.parent
부모님=n.parents
부분=n.part
부탁=n.request
분위기=n.atmosphere
불고기=n.bulgogi
비=n.rain
비행기=n.airplane
빵=n.bread
사과=n.apple
사람=n.person
사무실=n.office
사은품=n.freebie; bonus gift
사전=n.dictionary
사진=n.photo
산=n.mountain
색=n.color
색깔=n.colors
생각=n.thinking, thought
생일=n.birthday
생활=n.life
서울=n.Seoul
서울역=n.Seoul Station
서점=n.Bookstore
선물=n.present, gift
선생님=n.teacher
설명=n.explanation
설악산=n.Seoraksan
성격=n.character
소개=n.introduction
소식=n.news
손=n.hand
손님=n.customer
수업=n.class
수첩=n.pocket book
시간=n.time
시계=n.watch
시장=n.market
시청=n.city hall
시험=n.test
식당=n.resturant
식사=n.meal
신문=n.newspaper
신발=n.shoe
아기=n.baby
아래=n.bottom
아버지=n.father
아이스크림=n.ice cream
아저씨=n.sir, uncle
아주머니=n.ma'am, aunt
아침=n.morning
아침2=n.breakfast
아파트=n.apartment
안=n.in
안경=n.eye glasses
안내=n.information
앞=n.in front of
야구=n.baseball
약=n.medicine
약국=n.pharmacy
약속=n.appointment
어머니=n.mother
어제=n.yesterday
얼굴=n.face
여자=n.girl
여행=n.trip
역사=n.history
연락=n.contact
연필=n.pencil
영수증=n.recipit
영어=n.English
영화=n.movie
옆=n.beside
옛날=n.old
오래간만=n.after a long time
오랜만=n.after a long time
오른쪽=n.right direction
오후=n.afternoon
올해=n.this year
옷=n.clothes
외국인=n.foreigner
요리사=n.chef
요즘=n.these days
우산=n.umbrella
우유=n.milk
운동=n.exersise
웬일=n.what matter
위=n.upper part
유학=n.study abroad
은행=n.bank
음료수=n.drink
음식=n.food
음악회=n.concert
의미=n.meaning
의자=n.chair
이름=n.name
이번=n.this ~
이상=n.strange
인터넷=n.internet
일=n.work
일본=n.Japan
일본어=n.Japanese
일요일=n.Sunday
자동차=n.car
자리=n.seat
자전거=n.bicycle
작년=n.last year
잡지=n.magazine
장소=n.place
저녁=n.evening
전자사전=n.electronic dictonary
전화번호=n.phone number
점심=n.lunch
정리=n.arrangement
제주도=n.Jeju Island
졸업=n.graduate
주=n.week
주말=n.weekend
주소=n.address
주인=n.owner
준비=n.prepare
중국=n.china
지갑=n.wallet
지난주=n.last week
지난해=n.last year
지하철=n.subway
집=n.house
찻값=n.a tea charge
창문=n.Window
책=n.book
책상=n.desk
청소=n.clean
축구=n.football, soccer
취미=n.hobby
취직=n.getting a job
치마=n.skirt
친구=n.friend
침대=n.bed
카메라=n.camera
캐나다=n.Canada
커피=n.coffee
컴퓨터=n.computer
큰형=n.male's oldest brother
테니스장=n.tennis court
토요일=n.saturday
통장=n.bankbook
파란색=n.blue
파티=n.party
편지=n.letter
평일=n.weekday
포도=n.grape
표=n.ticket
품목=n.goods
피아노=n.paino
필요=n.need
하숙집=n.boarding house
학원=n.academy
한국=n.Korea
한국말=n.Korean speech
한국어=n.Korean language
한복=n.traditional Korean Clothes
한식집=n.Korean resturant
할머니=n.grandmother
할아버지=n.grandfather
할인=n.discount
행사=n.event
형=n.male's older brother
호=n.room number
호선=n.subway line
회사=n.company
회사원=n.office worker
회의=n.meeting
후=n.after
휴일=n.holiday
희망=n.hope
힘=n.effort
개=n.[C]general counter
권=n.[C]books
대=n.[C]machines
마리=n.[C]animal
명=n.[C]people
번=n.[C]times
병=n.[C]bottle
분=n.[C]people
사람=n.[C]people
살=n.[C]age
송이=n.[C]bunch of fruit
인분=n.[C]a serving of food
잔=n.[C]glass
장=n.[C]paper
층=n.[C]floor
통=n.[C]package
