가까이=adv.親しく,近く
가끔=adv.時たま,時折
가다=v.行く,帰る
가볍다=adj.軽い,簡単だ
가장=adv.装うこと,見せかけること
가져가다=v.持っていく,移す
가지고가다=v.取り合わせる
갈아타다=v.乗り換える
감기에걸리다=v.かんぼう
감사하다=adj.ありがたい,感謝する
갑자기=adv.にわかに,いきなり
갔다오다=v.行った織田
갖다=v.持つ
같이=adv.…のように,同じに
거기=pron.そちら,そこ
거의=adv.ほとんど,ほぼ
걱정하다=v.操心
건너가다=v.渡っていく,渡る
걸리다=v.かかる,ひっかかる
경험하다=v.経験けいけん
계속=adv.続けること,継続
계시다=adj.いらっしゃる,おられる
계획을세우다=v.て计画を立てる
계획하다=v.計画けいかく
고르다=v.平均している,均一だ
고맙다=adj.ありがたい,感謝する
고장이나다=v.わずらわしい
곧=adv.すぐ,ただちに
공기가맑다=adj.新鲜な空気
괜찮다=adj.結構だ,大丈夫だ
구경하다=v.番をする、見る
구하다=v.求める,さがす
그=pron.その,あの
그거=pron.それ
그것=pron.それ,あれ
그냥=adv.ただ,そのまま
그래서=conj.そうして,だから
그러나=conj.しかし,だが
그러니까=conj.だから,ですから
그러면=conj.そうだとすれば,それなら
그런데=conj.ところで,さて
그럼=conj.それなら,では
그리고=conj.文·句·節·語などを連結させるときに用いる語,そして
그리다=v.描く,つくる
글쎄요=int.おそらく、多分
금방=adv.今すぐ,今
기다리다=v.待つ
기분이좋다=adj.気分きぶん
기억을하다=v.覚えている
기억이나다=v.覚えている
길다=adj.長い,永い
길이막히다=v.通路を遮断
깊다=adj.深い,强い
깎다=v.削る,表面を薄くそぎとる
깨끗하다=adj.潔い,鮮やかだ
꺼내다=v.取り出す,切り出す
꼭=adv.力を入れて押さえたり締めたりするようす,しっかり
끄다=v.消す,スイッチを切って電流を止める
끊다=v.切る,断つ
끝나다=v.終わる,済む
끝내다=v.終える,すませる
끼다=v.かかる
나가다=v.出る,出場する
나다=v.出る,なる
나쁘다=adj.悪い,劣っている
나오다=v.出る,現われる
나중에=adv.後あと
날마다=adv.毎日,日ごと
낮다=adj.低い,少ない
내다돈=v.お金を
내리다=v.下りる,下す
너무=adv.度を越して,あまり
넓다=adj.広い,幅が広い
넣다=v.入れる,預け入れる
네=num.四つの,4
노래부르다=v.歌を歌う
노래하다=v.歌う
노력하다=v.努力どりょく
놀다=v.する,遊ぶ
농구하다=v.バスケットボールをする
높다=adj.高い,偉い
누구=adv.誰,疑問·不定を表わす
눈물이나다=v.叫び
늦게=adv.遅おそい
다=adv.皆,全部
다녀오다=v.行って来る,寄って来る
다니다=v.通う,往来する
다르다=adj.別の,違っている
닫다=v.閉める,ふさぐ
대답하다=v.返事へんじ
더=adv.もっと,さらに
더럽다=adj.きたない,卑しい
덥다=adj.体温が高い,熱がある
도착하다=v.到着とうちゃく
돈이들다=v.料金
돌아오다=v.帰ってくる,戻ってくる
되다=v.…になる,十分だ
두=num.二つの…,2…
드리다=v.上げる,差し上げる
드시다=v.(高齢者に)食べて
듣다=v.聞く,伝え聞く
들다=v.入る,なる
들어가다=v.入る,就職する
따뜻하다=adj.温かい,暖かい
따로=adv.別に,離して
떠나다=v.離れる,発つ
또=adv.また,再び
똑바로=adv.正直に,率直に
마시다=v.吸う,飲む
마음에들다=v.のような
마치다=v.終える,すます
마침내=adv.とうとう,ついに
만나다=v.遭う,遭遇する
만들다=v.つくる,作成する
많다=adj.多い,たくさんだ
많이=adv.多く,たくさん
말씀드리다=v.高齢者に話す
말씀하시다=v.話す
말하다=v.話す
맑다=adj.澄んでいる,清い
맛없다=adj.まずい,おいしくない
맛있다=adj.おいしい,面白い
매우=adv.たいへん,とても
매일=adv.毎日,日ごと
먹다=v.食らう,食べる
먼저=adv.先に,とりあえず
멋있다=adj.洗練されていること
몇=adv.何,幾
모두=adv.すべて,全部
모르다=v.知らない,分からない
모으다=v.ためる,集める
모자라다=v.足りない,欠ける
목욕하다=v.風呂に入る
못=adv.…できない,不可能の意を表わす
무섭다=adj.恐ろしい,怖い
무슨=adv.どんな,疑問の意を表わす
무엇=adv.何,未知の物を指す疑問代名詞
묻다=v.問う,尋ねる
물어보다=v.頼む
뭐=adv.何
미리=adv.あらかじめ,前もって
미안하다=adj.すまない,申しわけない
바로=adv.すぐ,正しく
반갑다=adj.懐かしい,喜ばしい
받다=v.受ける,取る
밝다=adj.明るい,通じている
밥먹다=v.食品を食べる
방금=adv.今,たった今
배가고프다=adj.飢えた
배가부르다=adj.フル
배고프다=adj.腹
배우다=v.習う,学ぶ
벌써=adv.もう,すでに
벗다=v.逃れる,脱ぐ
별로=adv.さほど,特別に
별히=adv.特別
보내다=v.送る,放して自由にしてやる
보다=v.見る,得る
보통=adv.一般的に,普通
복잡하다=adj.混雑している,複雑だ
부르다=v.呼ぶ,いう
부지런하다=adj.勤勉だ,まめまめしい
부치다=v.焼く,送る
부탁하다=v.頼たのみ
불편하다=adj.不偏ふへん
비슷하다=adj.ほとんど同じだ,似ている
비싸다=adj.高い,値が張る
빌려주다=v.貸してくれる,貸してやる
빌리다=v.借りる
빨리=adv.速く,素早く
빼다=v.取り除く,抜く
사고가=v.事故
사다=v.買う,招く
사용하다=v.使用しよう
사진을찍다=v.写真しゃしん
산책하다=v.散歩をする
살다=v.生きる,住む
새=pron.鳥
새로=adv.新たに,再び
새롭다=adj.新しい,初めてだ
서다=v.立つ,建つ
서로=adv.互い,双方
설거지하다=v.後片づけをする,皿洗いをする
설명하다=v.説明せつめい
세=num.借り料,借り賃
소개하다=v.紹介しょうかい
수영하다=v.泳ぐ
쉬다=v.休息をとる,休む
쉽다=adj.たやすい,易しい
스무=num.20
스물=num.20
슬프다=adj.かわいそうだ,あわれだ
시작되다=v.試作しさく
시작하다=v.試作しさく
시키다=v.させる,やらせる
식사하다=v.食事しょくじ
신다=v.履く
싫다=adj.いやだ,嫌いだ
싫어하다=v.嫌がる,嫌う
십삼=num.13
십이=num.12
싸다=adj.当たり前だ,当然だ
쓰다=v.かぶる,動かす
쓰다모자=v.ぼうしをかぶる
씻다=v.洗う,ふく
아까=adv.さっき,ちょっと前
아니요=int.いいえ
아름답다=adj.美しい,きれいだ
아마=adv.おそらく,たぶん
아무=pron.某,誰がし
아주=adv.とても,たいへん
아직=adv.まだ,いまだ
아프다=adj.痛い,悪い
아홉=num.9
안=adv.内,内部
앉다=v.座る,腰かける
알다=v.思う,互いに顔見知りである
알아듣다=v.理解する,納得する
어느=adv.どの,選択疑問を表わす
어둡다=adj.暗い,弱い
어디=adv.どこ,どちら
어떻게=adv.どうだ
어리다=adj.足りない,未熟だ
어서=adv.行動を促したり勧めたりするときの語,速く
어울리다=v.調和する,釣り合う
언제=adv.いつ,疑問を表わす
언제나=adv.しょっちゅう,いつも
얼마나=adv.いくらぐらい,どれぐらい
없다=adj.ない,存在しない
여기=pron.ここ,こちら
여러=pron.さまざまな,いろいろの
여러분=pron.皆さん,皆様
여보세요=int.見知らぬ相手に呼びかけたり,注意をうながすとき
여섯=num.六つ
여행하다=v.旅行りょこう
연락하다=v.連絡れんらく
연습하다=v.練習
열두=num.12
열셋=num.13
열심히=adv.一生懸命,熱心に
열이나다=v.熱ねつ
예=int.例,例の
예쁘다=adj.きれいだ,美しい
예약하다=v.予約よやく
오다=v.来る,生じる
오래=adv.長く,永らく
오래간만에=adv.長い時間で
오랜만에=adv.長い間
오르다=v.上がる,出る
올라오다=v.上つてくる、登つてくる
왜=adv.なぜ,なにゆえ
요즘=adv.これらの日
우리=pron.私たち,私たちの
우산을쓰다=v.傘を持つ
운동하다=v.運動
운전하다=v.運転うんてん
웃다=v.笑う,せせら笑う
위험하다=adj.危険きけん
유명하다=adj.有名だ,人一倍程度がはなはだしい
이=pron.歯
이거=pron.この
이것=pron.これ,今述べたことを指す
이따가=adv.のちほど,あとで
이사가다=v.他の場所に移動します
이사하다=v.理事りじ
이상하다=adj.おかしい,変だ
이야기하다=v.話はなし
이용하다=v.利用りよう
이제=adv.今,もうすぐ
이해하다=v.理解りかい
일어나다=v.立ち上がる,生じる
일찍=adv.早く,早目に
읽다=v.読む,読書する
잃다=v.失う,なくす
잃어버리다=v.なくす,失う
입다=v.負う,こうむる
있다=adj.ある,いる
잊다=v.忘れる
자주=adv.しばしば,よく
작다=adj.小さい,細かい
잘=adv.十分に,よく
잘되다=v.よくできる,うまくいく
잘하다=v.うまくやる,上手だ
잠깐=adv.しばらくの間,ちょっとの間
잠시=adv.しばらくの間,しばし
잠이오다=v.眠い
잡수시다=v.食べる
재미있다=adj.面白い
저=pron.あのう,ええ
저거=pron.それです
저것=pron.それです
저기=pron.あそこ,あちら
저희=pron.우리の謙譲語,私ども
적다=adj.記す,書き記す
전하다=v.伝える,知らせる
전혀=adv.全然,何にも
전화를걸다=v.電話
전화를바꿔주다=v.私がと話すことができる...
전화를받다=v.電話
전화를하다=v.コール
전화하다=v.電話でんわ
정말=adv.まこと,本当
제일=adv.最初,一番
조금=adv.少し,わずか
조심하다=v.注意してください
조용하다=adj.静かだ,もの静かだ
조용히=adv.静しずかに
좀=adv.ちょっと,少し
좁다=adj.狭い,小さい
좋다=adj.愉快だ,うれしい
좋아하다=v.好きだ,好む
죄송하다=adj.申し訳ない,恐れ多い
주다=v.出す,与える
주무시다=v.お休みになる
주문하다=v.注文ちゅうもん
준비하다=v.準備じゅんび
중요하다=adj.重要じゅうよう
즐겁다=adj.愉快だ,快い
지금=adv.今
지나다=v.過ぎる,超す
지내다=v.過ごす,暮らす
직접=adv.直接,じきじきに
질문하다=v.質問しつもん
짓다=v.つくる,つける
짧다=adj.低い,短い
참=adv.本当に,誠
찾다=v.さがす,さがし求める
찾아가다=v.会いに行く,訪ねて行く
처음=adv.いちばん初め,最初
천천히=adv.ゆっくりと,のんびりと
청소하다=v.清掃せいそう
초대하다=v.招待
축구를하다=v.遊ぶ
출발하다=v.出発しゅっぱつ
춥다=adj.寒い
취직하다=v.採用する
친절하다=adj.親切しんせつ
켜다=v.つける,挽く
콧물이나다=v.鼻水があります
크게=adv.大きく
크다=adj.大きい,高い
키가크다=adj.背の高い
타다=v.燃える,火がついて燃える
테니스치다=v.テニスをする
특히=adv.特に
틀리다=v.違う,狂う
편리하다=adj.便利だ,都合がいい
편안하다=adj.無事だ,安らかだ
편하다=adj.安らかだ,楽だ
푹=adv.力いっぱい深く突き刺すようす,きゅっと
푹자다=v.深く眠る
피곤하다=adj.疲労ひろう
피아노를치다=v.ピアノを弾く
필요하다=adj.必要ひつよう
하다=v.する,…という
한=num.限り,だいたい
한가하다=adj.ひまだ,のんびりと
함께=adv.同時に,いっしょに
항상=adv.常に,いつも
혼자=adv.一人で,単独で
혼자서=adv.一人で
화나다=v.怒った
회의하다=v.会議かいぎ
힘들다=adj.力
