의복=身に着けている
옷=服
양복=スーツ
단추=ボタン
운동복=スポーツウェア
주머니=ポケット
잠옷=パジャマ
지펴=ジッパー
파자마=ナイトウエア
원단=木綿素材
게주얼=カジュアルウェア
옷감=材料
평상복=ホーム服
실크=シルク
정장=全体衣類
면=コットン
아동복=子供の服
나이론 천=ナイロン布
웨딩드레스=ウエディング
방수=防水
작업복=オーバーオール
방풍=防風林
제복=ユニフォーム
스타일=スタイル
웃옷=ジャケット
입어보다=服にしてみてください
셔츠=シャツ
색깔=色
와이셔츠=ワイシャツ
양복바지=スーツのズボン
체크문늬 셔츠=格子縞のシャツ
진바지=ジーンズ
풀로셔츠=ポロシャツ
나팔바지=フレア
티셔츠=Tシャツ
타이트바지=タイトなパンツ
스웨타=セーター
반바지=ショートパンツ
조끼=ベスト
긴바지=すててこ
외투=コー​​ト
치마=スカート
코트=ウインドブレーカー
원피스=ドレス
스탠드 칼라=ハイ襟
긴치마=ロングスカート
라운드 칼라=ラウンド襟
짧은치마=スカート
V자 칼라=Vネック
타이트스커트=狭いスカート
반팔=半袖
미니스커트=ミニスカート
긴팔=長袖
바지치마=キュロット
민소매=ノースリーブの
문양=ファンシー
싱글=シングルブレスト
바지=パンツ
더블=ダブルブレスト
품옷부=装身具
넥타이=タイ
모자=ハット
밀짚모자=麦わら帽子
야구모자=野球帽
목도리=スカーフ
사냥모자=キャップ
스카프=スカーフ
허이띠=革ベルト
숄=ショール
장갑=手袋
손수건=ハンカチ
액세서리=ジュエリー
다이아몬드=ダイヤモンド
반찌=リング
보석=宝石
목걸이=ネックレス
금=ゴールド
코걸이=鼻輪
은=シルバー
귀걸이=イヤリング
손목시계=腕時計
브로치=ブローチ
팔찌=ブレスレット
넥타이핀=ネクタイピン
신=靴
구두=革靴
굽=靴のヒール
하이힐=かかとの高い靴
브랜드=ブランド
운동화=スポーツシューズ
신어보다=靴にしよう
로힐=フラットシューズ
사이즈=サイズ
헝겊신=布靴
크기=サイズ
슬리퍼=スリッパ
머리둘레=頭囲
샌들=サンダル
가슴둘레=バスト
부츠=ブーツ
허리둘레=ウエストライン
장화=レインブーツ
엉덩이둘레=ヒップ
뱀가죽=ヘビ革
신장=高さ
악어가죽=ワニ革
다리길이=脚の長さ
가죽=真皮
크다=素晴らしい
인조가죽=人工皮革
작다=スモール
구두끈=靴ひも
맞다=フィット
구두깔개=インソール
꽉끼다=タイト
양말=靴下
짧은양말=ショートソックス
스타킹=ストッキング
발목 양말=アンクルソックス
튜브 양말=筒靴下
무릎 양말=膝の靴下
팬티 스타킹=パンスト
무릎 스타킹=膝ストッキング
긴양말=ストッキング
망사 스타킹=網タイツ
면 양말=綿の靴下
발가락 양말=つま先の靴下
보트 양말=ボートソックス
