의복=衣着
옷=衣服
양복=西装
단추=钮扣
운동복=运动服
주머니=口袋
잠옷=睡衣
지펴=拉链
파자마=睡袍
원단=布料
게주얼=休闲服
옷감=质料
평상복=家居服
실크=丝质
정장=套装
면=棉质
아동복=童装
나이론 천=尼龙布
웨딩드레스=婚纱
방수=防水
작업복=工作服
방풍=防风
제복=制服
스타일=款式
웃옷=上衣
입어보다=试穿(衣服)
셔츠=衬衫
색깔=颜色
와이셔츠=白衬衫
양복바지=西装裤
체크문늬 셔츠=格子衬衫
진바지=牛仔裤
풀로셔츠=POLO衫
나팔바지=喇叭裤
티셔츠=T恤
타이트바지=紧身裤
스웨타=毛衣
반바지=短裤
조끼=背心
긴바지=长裤
외투=外套
치마=裙子
코트=风衣
원피스=连衣裙
스탠드 칼라=高领
긴치마=长裙
라운드 칼라=园领
짧은치마=短裙
V자 칼라=V字领
타이트스커트=窄裙
반팔=短袖
미니스커트=迷你裙
긴팔=长袖
바지치마=裙裤
민소매=无袖
문양=花色
싱글=单排扣
바지=裤子
더블=双排扣
품옷부=衣服配件
넥타이=领带
모자=帽子
밀짚모자=草帽
야구모자=棒球帽
목도리=围巾
사냥모자=鸭舌帽
스카프=丝巾
허이띠=腰带,皮带
숄=披肩
장갑=手套
손수건=手帕
액세서리=首饰
다이아몬드=钻石
반찌=戒指
보석=宝石
목걸이=项链
금=黄金
코걸이=鼻环
은=银
귀걸이=耳镮,耳坠
손목시계=手表
브로치=胸针
팔찌=手镯,手链
넥타이핀=领带夹
신=鞋子
구두=皮鞋
굽=鞋跟
하이힐=高跟鞋
브랜드=牌子
운동화=运动鞋
신어보다=试穿(鞋子)
로힐=平底鞋
사이즈=尺寸
헝겊신=布鞋
크기=大小
슬리퍼=拖鞋
머리둘레=头围
샌들=凉鞋
가슴둘레=胸围
부츠=长靴
허리둘레=腰围
장화=雨鞋
엉덩이둘레=臀围
뱀가죽=蛇皮
신장=身长
악어가죽=鳄鱼皮
다리길이=腿长
가죽=真皮
크다=大
인조가죽=人工皮
작다=小
구두끈=鞋带
맞다=合身
구두깔개=鞋垫
꽉끼다=紧
양말=袜子
짧은양말=短袜
스타킹=丝袜
발목 양말=踝短袜
튜브 양말=中统袜
무릎 양말=及膝袜
팬티 스타킹=连裤袜
무릎 스타킹=过膝长袜
긴양말=长统袜
망사 스타킹=网眼袜
면 양말=棉袜
발가락 양말=脚趾袜
보트 양말=船袜
