의복=wearing
옷=clothes
양복=suit
단추=buttons
운동복=sportswear
주머니=pocket
잠옷=pajamas
지펴=zipper
파자마=nightwear
원단=cotton material
게주얼=casual wear
옷감=material
평상복=home clothing
실크=silk
정장=entire clothing
면=cotton
아동복=children clothing
나이론 천=nylon cloth
웨딩드레스=wedding
방수=waterproof
작업복=overalls
방풍=windbreak
제복=uniform
스타일=style
웃옷=jacket
입어보다=try on clothes
셔츠=shirt
색깔=color
와이셔츠=white shirt
양복바지=suit pants
체크문늬 셔츠=plaid shirt
진바지=jeans
풀로셔츠=polo shirt
나팔바지=flares
티셔츠=T-shirt
타이트바지=tight pants
스웨타=sweater
반바지=short pants
조끼=vest
긴바지=long pants
외투=coat
치마=skirt
코트=windbreaker
원피스=dress
스탠드 칼라=high collar
긴치마=long skirt
라운드 칼라=round collar
짧은치마=skirt
V자 칼라=V-neck
타이트스커트=narrow skirt
반팔=short sleeve
미니스커트=mini skirt
긴팔=long sleeve
바지치마=culottes
민소매=sleeveless
문양=fancy
싱글=single-breasted
바지=pants
더블=double-breasted
품옷부=clothing accessories
넥타이=tie
모자=hat
밀짚모자=straw hat
야구모자=baseball cap
목도리=scarf
사냥모자=cap
스카프=scarves
허이띠=leather belt
숄=shawl
장갑=gloves
손수건=handkerchief
액세서리=jewelry
다이아몬드=diamond
반찌=ring
보석=gem
목걸이=necklace
금=gold
코걸이=nose ring
은=silver
귀걸이=earrings
손목시계=wristwatch
브로치=brooch
팔찌=bracelet
넥타이핀=tie clip
신=shoe
구두=leather shoes
굽=shoe heel
하이힐=high-heeled shoes
브랜드=brand
운동화=sports shoes
신어보다=trying on shoes
로힐=flat shoes
사이즈=size
헝겊신=cloth shoes
크기=magnitude
슬리퍼=slippers
머리둘레=head circumference
샌들=sandals
가슴둘레=bust
부츠=boot
허리둘레=waistline
장화=rain boots
엉덩이둘레=hips
뱀가죽=snakeskin
신장=height
악어가죽=crocodile leather
다리길이=leg length
가죽=dermis
크다=great
인조가죽=artificial leather
작다=small
구두끈=shoelace
맞다=fit
구두깔개=insole
꽉끼다=tight
양말=socks
짧은양말=anklet
스타킹=silk stocking
발목 양말=short sock
튜브 양말=in tube sock
무릎 양말=knee sock
팬티 스타킹=panty hose
무릎 스타킹=thigh stocking
긴양말=stockings
망사 스타킹=fishnet thigh
면 양말=cotton sock
발가락 양말=toe sock
보트 양말=boat socks
