호랑이도 제 말하면 온다더니=說曹操,曹操就到
원숭이도 나무에서 떨어질 때가있다=猴子也有失手的時候!
시시콜콜 따지지 좀 마라!=不要這樣斤斤計較,好不好
나이는 못속인다니까.=年紀不繞人
헛소리하지마!=胡說八道
사랑은 국경이 없습니다=愛情不分國界
빨리 가서 숙제나해!=快去作功課!
종이호랑이=紙老虎
거 말되는데! 일리있군!=有道理,有道理!
정말 죽여준다=眞是絶了!
차일시피일시=此一时彼一时
찬물도 우아래가 있다=冷水也有上下之分
참새가 방앗간을 거져 보내랴=本性难改
처녀가 아이를 낳아도 할말이 있다=无理还要搅三分
처삼촌 무덤에 벌초하듯=敷衍了事
천길 물속은 알아도 계집의 마음속은 모른다=千丈深水易测,女人之心难测
천리길도 한걸음부터=千里之行,始于足下
첫술에 배부를까=胖子不是一口吃的
청사에 길이 빛나리라=永垂靑史
치도곤을 먹이다=当头棒喝
치마 밑에서 키운 자식=娇养惯养的孩子
친구는 옛 친구가 좋고 옷은 새옷이 좋다=衣服是新的好,朋友是旧的好
친구 따라 강남 간다=随友江南往
칠면조같다=善变
침 발린 말=甜言蜜语
가는 말이 고와야 오는 말이 곱다=你不仁,我不义
가다가 중지 곧 하면 아니 감만 못하다=与其半途而废,宁可不做
가지만은 나무 바람 잘날 없다=多有孩子,多有苦心
가난한 집 제사 돌아오듯=越穷越见鬼,越冷越刮风
가는 날이 장날=来得早,不如来得巧
가는 말이 고와야 오는 말이 곱다=不说他秃,他不说
가는 정이 있어야 오는 정이 있다=人心换人心,人情换人情
가랑비에 옷 젖는줄 모른다=毛毛细雨湿衣裳,小事不防上大当
가루는 칠수록 고와지고 말은 할수록 거칠어진다=粉越筛越细,话越说越粗
가물에 단비=久旱逢甘雨
가물에 콩나듯=寥寥无几
가을이 지나지 않고 봄이 오랴 ?=冬不去春不来
가지 많은 나무가 바람 잘날이 없다=多枝的树上风不止,树枝多无宁日
가까운 남이 먼 일가보다 낫다=远亲不如近邻
가까운 무당보다 먼데 무당이 낫다=远来的和尙会念经
간에 기별도 안간다=喝水都塞牙缝
갈피를 못잡다=不知所错
감 놓아라 배 놓아라 한다=指手畵脚；多管闲事
감옥에 십년 있으면 바늘로 파옥한다=只要工夫深,铁杵磨成针
갓 쓰고 양복입는 격=不伦不类
강을 다스리는 사람이 천하를 다스린다=能治水者治天下
강 건너 불구경=隔岸观火
같은 값이면 다홍치마=有红装不要素装,有月亮不摘星星
같이 숨쉬고 같이 생각=同心同德
걱정도 팔자=天下本无事,庸人自扰之
건더기 먹은 놈이나 국물 먹은 놈이나=半斤八两,不相上下
검은 머리가 파뿌리되도록=白头偕老
김치국부터 마신다=未捉到熊,倒先卖皮
기운이 세다고 소가 왕노릇할까=有勇无谋成不了大器
길이 아니면 가지 말고 말이 아니면 듣지 말라=路不像路不要走,话不像话别去理
길고 짧은 것은 대봐야 안다=实在去做才能明白谁强谁弱.对照以前不能说什么是强弱.
꼬리가 길면 밞힌다=千天做贼,必有一日败,狐狸尾巴藏不住
개팔자가 상팔자다=狗八字倒是好命运
개구리 올챙이 시절 기억 못한다=得了金饭碗,忘了叫街时；得鱼忘筌
개미구멍이 뚝을 무너뜨린다=千里长堤,溃于蚁穴
개천에서 용났다=穷山沟里出壮元,茅屋出高贤
개똥밭에도 이슬 내릴 날이 있다=穷人也有出头之日,千年瓦片也有飜身之日
개천에서 용났다=一步登天
개똥도 약에 쓰려면 없다=俯视就拾的,无价值的东西.平时没有觉悟到这东西的重要性或用场,可是要把它用作药材,竟然找不着.
게도 구럭도 다 놓치다=鸡飞蛋打
게눈 감추듯=狼呑虎咽
게모가 전처 자식 생각하듯=如后娘疼前妻孩子,走走好看
계집은 남의 것이 곱고 자식은 제 새끼가 곱다=老婆是人家的好,孩子是自己的好
계란으로 바위치기=以卵击石
고기는 씹어야 맛이고 말은 해야 맛이다=肉不嚼不香,话不说不明,鼓不打不向,话不说不明
고기도 저놀던 물이 좋다고 한다=好家难舍,熟地难离
고래 싸움에 새우등 터진다=龙虎相鬪,鱼虾遭殃,城门失火,殃及池鱼
고양이 보고 반찬가게 지키란다=让猫看肉
고양이 쥐생각=猫兒疼老鼠
고양이와 개=勢不兩立；針尖對麥芒
고양이목에 방울걸기=猫顶悬铃
고인물이 썩는다=積水易腐
고생 끝에 낙이 온다=苦尽甘来
곪으면 터지는 법=物極必反,否極泰來
곱다고 안아준 간난애가 바지에 똥을 싼다=狗咬呂洞宾,不知好歹
공든 탑이 무너지랴=皇天不負苦心人
공자 앞에서 문자 쓴다=班门弄斧
구두 신고 발등 긁기=隔靴搔痒
구렁이 담 넘어가듯=含糊其詞
구슬이 서말이라도 꿰어야 보배=玉不琢不成器
군불에 밥짓기=因利乘便
군자대로=君子大路行
굶은 놈이 이밥조밥 가리냐=饑不擇食
굿이나 보고 떡이나 먹지=袖手傍觀,坐享其成
궁하면 통한다=窮則變,變則通
궁지에 몰린 쥐가 고양이를 물다=狗急跳墻
급하다고 바늘허리에 실매여 쓸가=欲速則不達
귀에 걸면 귀걸이 코에 걸면 코걸이=言人人殊,嘴里兩張皮
귀머거리 삼녀 벙어리 삼년 장님 삼년=聾三年,啞三年,瞎三年
귀신이 곡할 일=神乎其神,鬼使神差,活見鬼
귀한 자식 매로 키워라=棍头出孝子,娇养是逆子,棒头出孝子
귀한 자식 매 한 대 더 때린다=不打不成材
과부사정은 과부가 안다=寡妇的难处,寡妇知道
까놓고 말하다=打开天窗说亮话
까마귀가 백로되기를 바란다=癞哈蟆想吃天鹅肉,吃心妄想
까마귀 날자 배 떨어진다=乌飞梨落,偶然的巧合
꺽일지언정 굽히지 않는다=宁死不屈
꼬리가 길면 잡힌다=爱走夜路,总要撞鬼,夜长梦多
꽁무니를 빼다=拔脚跑掉,溜走; 抱头鼠窜,掉头就跑
꾸어 온 보리자루=默不作声的人,窝囊废,草包
꿈인지 생시인지=梦境还是现实
꿈은 아무렇게 꿔도 해몽은 좋아라=不怕做恶梦,圆梦要中肯
깨물어서 아프지 않은 손가락이 없다=十个指头个个疼
꿩대신 닭=无牛捉了马耕田
꿩 먹고 알 먹기=一箭双雕,一举两得
낫 놓고 기역자도 모른다=目不识丁
노기가 상투밑까지 치밀다=怒发冲冠
노루가 제 방귀에 놀란다=胆小如鼠
누가 누구를 하는 판가리싸움=你死我活的斗争
누운 소 타기=易如反掌
눈에 든가시=眼中钉,肉中刺
눈에 풍년인데 배는 흉년이다=眼饱肚子饿
눈은 있어도 망울이 없다=有眼不识泰山
늙은 말이 길을 안다=老马识途
늙은 소 콩 밭으로=老奸巨滑
념불에는 맘이 없고 재밥에만 맘이 있다=醉翁之意不在酒
다리 뻗고 자다=高枕无忧
닫는 말에 채죽질=快马加鞭
달도 차면 기운다=月满则亏,水满则溢
당나무에 낫걸기=螳臂挡车
닭 소보듯=老死不相往来
닭잡아 먹고 오리발 내놓는다=瞒天过海
닭쫓던개 지붕쳐다 본다=逐鸡望篱
더워먹은소 달만 봐도 헐떡인다=吴牛喘月
덮여 놓고 열닷량금=不问三七二十一
도적놈에게 문 열어 준다=引狼入室
도적놈이 도적아 한다=贼喊捉贼
도적이 제발이 저리다=做贼心虚
도적 맞고 사립 고친다=亡羊补牢
도적을 앞으로 잡지 뒤로 못 잡는다=捉贼捉赃
도적해온 그 내도루지 못한다=偷来的锣鼓打不得
독불 장군=一个篱笆三个桩,一个好汉三个帮
독안에 든 쥐=瓮中之鳖
돈을 물 쓰듯한다=挥金如土
동이 닿지 않는 소리=风马牛不相及
똥싸개도 삼년하면 바자탈 넘군다=愚者千虑必有一得,智者千虑必有一失
돼지가 깃을 물어들이면 비가 온다=月晕而风,础润而雨
되로 주고 말로 받는다=小斗出,大斗进
두 손벽이 맞아야 소리 난다=孤掌难鸣
두 손에 떡 쥔 격=进退两难
두메 앉은 리방이 조정일 알듯=秀才不出门全知天下事
뒤뒤에 손가락 자리 나다=十目所见,十指所指
들으면 병이요 안 들으면 약이다=耳不听心不烦,眼不见心不烦
등불에 날아드는 하루산이=飞蛾扑火,惹火烧身
등잔 밑이 어둡다=八灯台照远不照近（灯下黑）
막내아들이 첫아들=独一无二
리씨네 사촌보다 민씨네 팔촌이 더 낫다=近水楼台先得月
말로 천량 빚을 갚는다=口惠而实不至
말꼬리의 파리가 천리 간다=仗势欺人
말만하면 사촌을 기와집 지어 주겠다=哗众取宠
말타면 경마 잡히고 싶다=得陇望蜀
말태우고 보선 깁는다=临时上轿穿耳杂
매화도 한철 국화도 한철=花无百日红
먹자니 싫고 버리자니 아깝다=食之无味,弃之可惜
메구라기 한마리 온 새물 재친다=害群之马
명약은 입에 쓰다=良药苦口
모기 보고 칼 뺀다=杀鸡用牛刀
모르로 먹으면 다 약이 된다=不干不净吃了没病
모진놈 옆에 섰다가 벼락맞는다=城门失火殃及池
목마른 사람이 우물 판다=临渴掘井（临时抱佛脚）
무자식 상팔자=无官一身轻
인생의 위대한 목표는 지식이 아니라 행동이다=人生的伟大目标,不是知识而是行动.
건강은 제일의 재산이다=健康是最重要的财产.
남의 생활과 비교하지 말고 제 자신의생활을 즐겨라=不要跟别人比较生活,而是要享受自己的生活.
인생은 하나의 실험이다.실험이 많아질수록 당신은 더 좋은 사람이 된다=人生是一种实验,越多的实验,让你变成更好的人.
많이 알기 위해서는 많이 공부해야 한다=为了多了解,一定要多读书.
질병은 몸의 고장이 아니라 마음의 고장이다=疾病不是身体的故障,而是心理的故障.
벗이 먼곳으로부터 찾아오니 이 얼마나즐거운가=朋友从远方来找你,这是多么令人开心的事啊！
착한 아내와 건강은 남자의 가장 훌륭 한재산이다=善良的太太和健康,是男人最庞大的财产.
자연과 시간과 인내는 3대 의사다=自然,时间与忍耐是三大医生.
젊을 때에 배움을 소홀히 하는 자는 과거를 상실하고 미래도 없다=年轻时忽略学习的人,会丧失过去,也没有未来.
유붕자원방래면,불역낙호아=有朋友自远方来,不亦乐乎.
친구는 제2의 재산이다=朋友是第二个财富.
슬픔을 나누면 반으로 되지만,기쁨을 나누면 배가된다=分担悲哀会减半,分享快乐却会加倍.
배우지 않으면 곧 늙고 쇠해진다=若不学习,会马上变衰老和虚弱.
노동은 생활의 꽃이요,삶의 보람이요,마음의 기쁨이다=劳动是生活之花,人生之成就,心理之快乐.
부모를 공경하는 효행은 쉬우나,부모를 사랑하는 효행은 어렵다=尊敬父母的孝行很容易做到,但是爱父母的孝行却很困难.
사람이란 자기가 생각하는 만큼 결코행복하지도 불행하지도 않다=人绝对不是自己想象中的,那么幸福或者那么不幸.
행복을 졸겨야 할 시간은 지금이다. 행복을 즐겨야 할 장소는 여기다=要享受幸福的时间是"现在",要享受幸福的地方在"这里".
말을 많이 한다는 것과 잘 한다는 것은 별개이다=话多与很会讲话是两回事.
그 사람됨을 알고자 하면 그의 친구가 누구인가를 알아보라=想知道他的为人,先去了解他的朋友是谁.
내가 성공을 했다면 오직 천사와 같은 어머니의 덕이다=若我成功,全因为母亲的恩德.
정직을 잃은 자는 더 이상 잃을 것이없다=一个失去诚实的人,再没有可以失去的东西了.
수면은 피로한 마음의 최상의 약이다=睡眠是治疗心情疲惫的最佳药方.
형제는 하늘이 내려주신 벗이다=兄弟是上天赐予的好朋友.
합한 두 사람은 흩어진 열 사람보다 낫다=两个人一起合作,比分散的十个人好.
국가는 시민의 하인이지 주인이 아니다=国家服务于民众而不是相反.
말도 아름다운 꽃처럼 그 색깔을 지니고 있다=语言像美丽的花朵,拥有它的颜色.
늘 재산이 없는 이는 늘 마음이 없다=没有财产的人,没有心机.
아는 것을 안다 하고 모르는 것을 모른다 하는 것이 말의 근본이다=知则知,不知则不知,是说话的根本.
부자는 망해도 삼년 먹을 것이 있다=富翁们就算破产了,也有三年的存粮.
일이 즐겁다면 인생은 극락이다,괴로움이라면 그것은 지옥이다=如果做事很快乐,则人生是极乐的,如果很痛苦,则是地狱.
나는 세계의 시민이다=我是世界公民.
다른 사람을 비웃지 말라,자기의 행복이 영원한것이라고 누가 장담할 것인가=不要嘲笑别人,谁能保证自己能永远幸福.
유쾌하게 지내는 것이 육체와 정신에가장 좋은 건강법이다="快乐的生活"对身体和精神而言,是最好的保健方法.
가장 감사해야 할 것은 신이 주신 능력을 제대로 이용하는 것이다=将神赐予我们的能力正确地使用,是最好的答谢.
마음이 없으면 보고도 안 보이고 들어도 귀에 들리지 않는다=无心则视若无睹,充耳未闻.
무엇이든지 풍부하다고 반드시 좋은 것은 아니다=物以稀为贵.
가는 자는 쫓지 말지며,오는 가는 막지 말라=往者不追,来者不拒.
가장 높은 곳에 올라가려면,가장 낮은 곳부터 시작하라=登高必自卑.
유능한 사람은 언제나 배우는 사람인것이다=时时刻刻学习的人,就是有能力的人.
인생의 목적은 끊임없는 전진에 있다=人生的目的是要不断的往前迈进.
우정은 풀어야지 끊지 말라=友情之花要细心呵护.
행복한 사람이 행복한 세상을 만듭니다=幸福的人创造幸福的世界.
친구와 포도주는 오랜 것이 좋다=朋友和葡萄酒是越久越好.
건강과 지성은  인생의 두가지 복이다=健康和智慧是人生的两大福分.
