텔레비전=電視機
안전보호망=安全護網
리모컨=遙控器
180도회전=180度旋轉
설명서=說明書
360도회전=360度旋轉
보증서=保證書
정시=定時
보증기한=保證期限
에어컨=冷氣機
조작설명=操作說明
독립식=獨立式
사용 방법=使用方法
분리식=分離式
기능=功能
전통형 에어컨=窗型冷氣
채널=頻道
기능=功能
소리=音量
전기절약=省電
사이즈=尺寸
소리없는=靜音
컬러=彩色
항균=抗菌
흑백=黑白
수면장치=睡眠裝置
밝기=明亮
컴퓨터온도조절=微電腦控溫
영상=影像
전화기=電話機
화질=畫質
무선전화기=無線電話
플러그=插頭
유선전화기=有線電話
소케트=插座
상대방번호명시기능=來電顯示功能
전선=電線
응답기=答錄機
전압=電壓
구내전화=分機
볼트=伏特
수화기=話筒
배터리=電池
리다이얼=重撥
스위치=開關
패스트 다이얼=速撥
버튼=按鈕
보류하다=保留
켜다=打開
대기하다=等待
끄다=關掉
교환하다=轉接
조정하다=調整
구내전화=內線
선택하다=選擇
통화중=占線
누르다=按
충전시키다=充電
비디오플레이어=錄放影機
메모리번호=記憶號碼
비디오테이프=錄影帶
전등=電燈
VCD플레이어=光碟機
현관등=日光燈
예약녹화=預錄
스텐드=檯燈
절전장치=定時開關
펜던트등=吊燈
리와이드=倒帶
등갓=燈罩
쾌속=快轉
전구=燈泡
플레이하다=播放
와트수=瓦數
길이=長度
세탁기=洗衣機
고장나다=故障
탈수기=脫水機
음향=音響
건조기=烘乾機
미니음향=床頭音響
스테인레스=不銹鋼
워크맨=隨身聽
헹구다=洗淨
CD플레이어=CD隨身聽
탈수하다=脫水
라디오=收音機
용량=容量
모타=馬達
카세트=錄音帶
보일러=熱水器
스피커=喇叭
전기보일러=電熱水器
음향효과=音效
기스보일러=燃氣熱水器
이어폰=耳機
자기해드=磁頭
환풍기=排油煙機
미이크=麥克風
기름여과망=濾油網
냉장고=電冰箱
가스렌지=燃氣爐
싱글도아=單門
가스=燃氣
더블도아=雙門
전자렌지=微波爐
냉동=冷凍
오븐=烤箱
냉장=冷藏
토스터=烤麵包機
온도=溫度
밥솥=飯鍋
섭씨5도=攝氏5度
전기밥솥=電子鍋
영하1도=零下1度
전기찜통=燜燒鍋
제빙칸=制冰盒
믹서=果汁機
토마=保鮮盒
쥬서=榨汁機
달게칸=置蛋架
계란믹서=打蛋機
채소과일칸=果菜箱
커피포트=咖啡壺
음료수칸=飲料架
보온병=熱水瓶
냄새제거장치=除臭裝置
생수기=飲水機
얼음제거=退冰
생수=生水
얼음=冰塊
끓인물=開水
서리=霜
비등좀=沸點
프레온가스=冷媒
제습기=除濕機
물 새다=漏水
가습기=加濕機
선풍기=電風扇
공기청정기=空氣清潔機
입식건풍기=立扇
난로=暖爐
천정선풍기=吊扇
헤어드라이어=吹風機
풍속=風速
자동제봉기=自動裁縫機
강=強
진동청소기=吸塵器
중=中
카메라=照相機
약=弱
픽업카메라=攝影機
