거울=鏡子
경대=鏡臺
구두=皮鞋
모자=帽子
목걸이=項鍊
물건=東西,物品
밉다=穿
바지=褲子
반지=戒指
벨트=皮帶
사다=買
세탁기=洗衣機
셔츠=襯衫
신발=鞋子
신화=鞋
안경=眼鏡
양말=袜子
양복=西裝
옷=衣服
옷을사다=買衣服
옷장=衣櫃
우산=雨傘
운동화=運動鞋
장갑=手套
제복=制服
주머니=口袋
지갑=錢包
치마=裙子
코트=大衣
티셔츠=T裇
헌복=韓服
