음악=音樂
악기=樂器
음표=音符
피아노=鋼琴
바이올린=小提琴
기타=結他
드럼=鼓
플루트=長笛
드럼펫=小號
가야금=伽倻琴(韓國的一種傳統樂器)
가수=歌手
가사=歌詞
노래=歌曲
부르다=[他動]唱
춤추다=[動]跳舞
발라드=抒情樂曲
재즈=爵士樂
클래식=古典樂
팝송=流行曲
농악=農樂
힙합=hip-hop
음악프로=音樂節目
오락=娛樂
드라마=劇集
영화=電影
극장=劇場
필름=膠卷film
카세트=卡式帶
콘서트=演唱會
음악회=音樂會
라디오=收音機
이터넷=網絡
게임=游戲
선수=選手
운동하다=運動
탁구=乒乓球
축구=足球
축구공=足球
야구=棒球
배구=排球
농구=籃球
농구공=籃球
야구공=棒球
테니스=網球
수영=游泳
배드민턴=羽毛球
대권도=跆拳道
골프=哥爾夫
조깅=慢跑
스키=滑雪
권투=拳擊
마음에들다=滿意,合心意
아야기=故事;談話
영화표=電影票
등산=登山
꽃=花
축하하다=[動]祝賀
돈=錢
우표=郵票
펜팔=筆友
보내다=[動]寄,送
편지=信
연애=戀愛,愛情
반지=戒指
놀다=[動]玩
휴대푼=手機
닫다=[動]關
받다=[動]收到
