고맙습니다=謝謝
감사합니다=謝謝(較正式)
배우다=[動]學習
공부하다=學習
공부=學習
읽다=讀,念
그리다=畫
그림=畫
듣다=聽
보다=看
펴다=翻開
따라하다=跟著做
사전=詞典
수첩=手冊,小筆記本
우표=郵票
숙제=作業
책=書
가방=書包;皮包
공책=筆記本
연필=鉛筆
볼펜=圓珠筆
지우개=橡皮擦
칠판=黑板
책상=書桌
의자=椅子
서랍=抽屜
필통=筆筒
컵=杯子
시계=錶
반=班
교실=教室
학교=學校
도서관=圖書館
학생색당=學生食堂
운동장=運動場
학생증=學生證
수업이끝니다=下課
시험=[試合]考試
읽기=[名]閱讀
듣기=[名]聽力
연습=[名]練習
몇=[數]多少
개=[量詞]個
쓰다=[動]寫
빨리=[副]快
일어니다=[動]起床
대학교=大學
사다=[動]買
앉다=坐
찾다=找
씻다=洗
먹다=吃
가다=去
하다=做
옳다=[形]對的
이야기=[名]談話;故事
자다=睡覺
주무시다=就寢
대학생=大學生
한국말=韓語
고양이=貓
컴퓨터=電腦
신문=報紙
잡지=雜誌
뉴스=新聞
텔레비전=電視
바자=義賣會
저=(謙稱)我
나=我
너=(常用於夫妻間爭吵時)你
그대=你,您
그=他
그녀=她
저희=(謙稱)我們
우리=我們
너희들=你們
그들=他們
그녀들=她們
여러분=(敬語)各位
모두=大家
