살다=住
집=家;房屋
하숙집=寄宿家庭
기숙사=寄宿舍
정문=前門,正門
문=門
복도=門廳,走廊
계단=樓梯
아뜰=庭院
발코니=陽臺
벽난로=壁爐
커튼=窗簾
덧문=百葉窗
천장=天花板
빌딩=大廈
타워=高樓
세탁기=洗衣機
전화=電話
화분=花盆
마루=地板
가정=家庭
엘리베이터=升降機
화단=花壇
가구=傢俱
꽃병=花瓶
청소기=吸塵機
선풍기=風扇
비=掃把
유리=玻璃
창틀=窗框
창문=窗戶
생활용픔=生活用品
의자=椅子
책상=書桌
서랍=抽屜
책장=書櫃
옷장=衣櫃
찬장=碗櫃
침대=床
소파=沙發
융단=地毯
벽지=牆紙
거울=鏡子
식탁=餐桌
방=房間
거실=居室(客廳)
수파=沙發
부엌=廚房
마당=院子
화장실=化妝室(洗手間)
고향=故鄉
차고=車庫
우펜함=信箱
근처=近處(附近)
가게=店
백화점=百貨公司
건물=(建物)建築
서점=書店
학생회관=學生會館
휴게실=休息室
교회=教會
우체국=郵局
은행=銀行
빵집=麵包店
약국=藥局
병원=醫院
체육관=體育館
시장=市場
경찰서=警察署
극장=劇場
회사=公司
슈퍼마켓=超市
주차장=駐車場
대공원=大公園
산=山
