지도=地圖
길=路
성=城
거리=街道
근처=附近
차도=馬路
인도=行人道
섬=島
공원=公園
육교=天橋
지하도=地下道
지하철=地下鐵
신호등=紅綠燈
황단보도=斑馬線
차=車
자동차=汽車
자전거=自行車
기차=火車
나가다=[動]出去
들어가다=[自動]進
앉다=[自]坐
타다=[他]乘坐
우산을쓰다=打傘
여행=旅行
관광=觀光
출국=出國
귀국=歸國
고향=故鄉
관광지=觀光景點
풍경=風景
드라이브=兜風
도착하다=[動]到達
끝나다=[動]結束
나오다=[動]出來
가다=[動]去
오다=[動]來
공항=空港(機場)
역=站
명동=明洞
동대문=東大門
시장=市場
오사카=大阪
외국=外國
설악산=雪岳山
경주=慶州
나라=國家
타이완=台灣
중국=中國
영국=英國
이탈리아=意大利
프랑스=法國
독일=德國
네덜란드=荷蘭
유럽=歐洲
아시아=亞洲
호주=澳洲
아프리카=非洲
아메리카=美洲
상하이=上海
도쿄=東京
일본=日本
파키스탄=巴基斯坦
미국=美國
뉴욕=紐約
한국=韓國
서울=首爾
제주도=濟州島
