이름=姓名
선생님=老師
성=姓
홍차=紅茶
그리고=和
친구=朋友
어느=哪(個)
나라=國家
미국=美國
중국=中國
아니요=不
일본=日本
그렇습니까=是嗎
영국=英國
독일=德國
러시아=俄羅斯
국적=國籍
에서=在一場所做~
회사원=公司職員
그럼=那麼
학생=學生
대학생=大學生
직업=職業
경찰=警察
가수=歌手
의사=醫師
간호사=護士
은행원=銀行員
비서=秘書
향수=香水
처음 뵙겠습니다=初次見面
가다=去
오다=來
만나다=見面
인사하다=打招呼
자다=睡
먹다=吃
입다=穿
듣다=聽
읽다=讀
쓰다=寫
학교=學校
에=表示地點或時間的助詞
점원=商店店員
이것=這個(東西)
교과서=課本
그렇다=是的
저것=那個(東西)
사전=辭典
잡지=雜誌
읽기책=讀物
책상=書桌
지갑=錢包
연필=鉛筆
자=尺
지우개=擦布
볼펜=原子筆
돈=錢
카드=卡
여권=護照
신분증=身份證
가방=包包
손수건=手帕
모자=帽子
거울=鏡子
휴지=衛生紙
공책=筆記本
열쇠=鑰匙
수첩=手冊
선생님=老師
과자=餅乾
종이=紙
필통=鉛筆盒、筆筒
이=這
그=那
저=那
그것=那個
저건=那個(東西)
여기=這兒
있다=有、在
달력=日曆
지도=地圖
없다=沒有、不在
교실=教室
창문=窗戶
분필=粉筆
칠판=黑板
그림=畫
옷걸이=衣櫃
문=門
텔레비전=電視
의자=椅子
많다=多
적다=少
크다=大
작다=小
날씨=天氣
좋다=好
나쁘다=不好
도=也
물건=東西
하고=和、跟
주머니=口袋
안 계십니다=不在
화장실=洗手間
식당=(食堂)餐廳
우체국=郵局
사무실=辦公室
숟가락=湯匙
젓가락=筷子
상자=箱子
앞=前
뒤=後
옆=旁邊
위=上
밑/아래=下
안=裡
밖=外
컴퓨터=電腦
컵=杯子
우유=牛奶
신문=報紙
전화=電話
맥주=啤酒
옷=衣服
침대=(寢臺)床
냉장고=(冷藏庫)冰箱
에서=在一場所做~
방=房間
종이=紙
뉴스=電視新聞
층=層、樓
지하=地下
있다=有、在
없다=沒有、不在
집=家
근처=附近
지하절=地鐵
역=站
백화점=百貨公司
극장=劇場
병원=醫院
입다=穿
약국=藥局
회사=公司
가게=店
공원=公園
시장=市場
주사기=(注射器)針
우리=我們
버스=巴士
정류장=車站
커피숍=咖啡站
하고=和、跟
교회=教會
참=真的
하다=做
가죽=家人
사진=(寫真)照片
보다=看
자주=經常
가끔=偶爾
증명사진=(證明)大頭照
일=工作
공부=學習
숙제=(宿題)作業
이야기=故事
노래=歌曲
운동=運動
산책=散步
사다=買
밥=飯
김치=泡菜
영화=電影
날마다=每天
음악=音樂
부르다=唱、叫
매일=每天
몇=幾、多少
명=名(人的單位)
아버지=爸爸
어머니=媽媽
누나=姐姐(男稱)
모두=都,一共
부모님=父母
계시다=在(敬)
고향=家鄉
전부=全部
할아버지=爺爺
할머니=奶奶
외할아버지=外公
외할머니=外婆
형=哥哥(男稱)
오빠=哥哥(女稱)
언니=姐姐(女稱)
나=我
동생=弟弟妹妹
형제=兄弟
오다=來
께서=이/가的敬語
주무시다=睡(敬)
잡수시다=吃(敬)
드시다=用、吃(敬)
말씀하시다=說話(敬)
말하다=說話
하나=一
둘=二
셋=三
넷=四
다섯=五
여섯=六
일곱=七
여덟=八
아홉=九
열=十
스물=20
서른=30
마흔=40
쉰=50
백=百
천=千
만=萬
홍차=紅茶
녹차=綠茶
밀크티=奶茶
버블티=珍奶
꼬피=鼻血
개=個
권=本
좋아하다=喜歡
읽씹하다=已讀不回
카메라=照相機
셀카봉=自拍棒
유치원=幼稚園
주부=家庭主婦
안=不、沒
고등학생=高中生
재미있다=有意思
같이、함께=一起
살다=居住、生活
에서=在一場所做~
심심하다=(沒事)無聊
지루하다=厭煩無聊
으시/시=對主詞的尊敬
산=山
공기=空氣
조용하다=安靜
시끄럽다=吵
깨끗하다=乾淨
더럽다=髒
넓다=寬
좁다=窄
춥다=冷
덥다=熱
시원하다=涼爽
따뜻하다=溫暖
예쁘다=漂亮
복잡하다=擠、亂、複雜
들=們
바다=海
그래서=所以
생선=魚
겨울=冬天
여름=夏天
친절하다=親切
사랑하다=愛
얼굴=臉
손=手
쉽다=簡單
어렵다=難
싸다=便宜
가깝다=近
어떻다=怎麼樣
대학교=大學
경제학=經濟學
전공=專業
혼자=獨自
그럽시다=那樣做吧
나가다=出去
들어오다=進來
올라가다=上去
내려오다=下來
한식집=韓式餐廳
바지=褲子
비빔밥=拌飯
불고기=烤肉
내일=明天
앉다=坐
정문=正門
가깝다=近
음식=食物
오늘=今天
값=價格
을까요/ㄹ까요=向對方提議或詢問意見
읍시다/ㅂ시다=一起做某事
시키다=點(餐)
무슨=什麼
맛있다=好吃
맵다=辣
외국인=外國人
잘=好
자장면=炸醬麵
초밥=壽司
양식=西餐
스테이크=牛排
달다=甜
쓰다=苦
시다=酸
짜다=鹹
싱겁다=淡
맛없다=不好吃
알다=知道
열다=開
놀다=玩
만들다=做
아이스크림=冰淇淋
좀=一點
간장=醬油
고추=辣椒
식혜=酒釀
카레=咖哩
지 않다=表示否定
고 싶다=想、打算
갈비=排骨
삼겹살=五花肉
찌개=鍋
닭갈비=雞排
삼계탕=人參雞
냉면=冷麵
김밥=紫菜包飯
떡볶이=辣炒年糕
잡채=雜菜
아침=早上
점심=中午
저녁=晚上
꿈을 꾸다=做夢
그림 그리다=畫畫
인분=份
중에서=當中
보통=(普通)一般
상추=生菜
겠=與動詞連用,表說話人意志
종업원=服務員
뭘=什麼
드리다=呈、給(敬)
주다=給
물=水
눈물=眼淚
잔=杯
병=瓶
그릇=碗
사탕=糖
초콜릿=巧克力
소주=燒酒、白酒
사과=蘋果
배=肚子
고브다=餓
다리=腿
찾다=找
아프다=痛
단어=單詞
모르다=不知道
오렌지=橙子
케이크=蛋糕
생일=生日
영어=英語
일어=日語
무엇=什麼(n.)
무슨=什麼樣的(adj.)
콤비네이션=總匯
피사=披薩
볶음밥=炒飯
탕수육=糖醋肉
손님=客人
고객=顧客
물냉면=冷麵
술집=酒館
마시다=喝
지금=現在
시=時、點
분=分
원=元
시간=時間
반=半
시계=時鐘
오전=上午
오후=下午
쯤=左右
회의=會議
잠깐=一會兒、稍微
과/와=和
고맙다=謝謝
싶어하다=想(第三人稱)
까지=到~
월=月
며칠=幾號
글쎄요=嗯
쉬다=休息
지요=吧,呢
월요일=星期一
화요일=星期二
수요일=星期三
목요일=星期四
금요일=星期五
토요일=星期六
일요일=星期日
하숙집=家庭旅館
어서=快
드라마=劇
아버님=伯父
분=位
게임=遊戲
이번=這次
여행=旅行
거기=那兒
방학=(學校的)假期
언제=啥時
날=天
시험=考試
졸업식=畢業典禮
파티=宴會、聚會
부터=從
때=時
일어나다=起床
수업=課、授業
과=科
배우다=學
술=酒
세수하다=洗臉
이를 닦다=刷牙
타다=搭、乘
잠=(睡)覺、睡眠
손을 씻다=洗手
비누=肥皂
안색=臉色
세안제=(洗顏劑)洗面乳
유리=(琉璃)玻璃
동아리=社團
도둑=小偷
칫솔=牙刷
피부=皮膚
치과=牙科
치약=(齒藥)牙膏
춤을 추다=跳舞
식사=吃飯
하루=一天
학원=(學院)補習班
싫어하다=討厭
살=歲
다=都
발=腳
발끝=腳尖
머리=頭
하나도=一點也不
담배를 피우다=抽煙
졸업하다=(卒業)畢業
그저께=前天
모레=後天
바쁘다=忙
뛰다=跑
자신=自信
용기=勇氣
어제=昨天
아름답다=漂亮,好看
그제=前天
지난=上個
다음=下個
주=週
달=月
년=年
모레=後天
작년=去年
올해=今年
내년=明年
기다리다=等候
운동장=運動場
구두=皮鞋
쇼핑=購物
기분=心情
도시락=便當
편지=(便紙)信
반친구=同學
동찬=(同窗)同學
잘생가다=長得很好
택시=計程車
잡다=抓住
씹다=嚼
선물=禮物
장미꽃=玫瑰花
꽃 가게=花店
빵=麵包
빵집=麵包店
예물=禮物(婚禮送的)
잎=葉子
꽃잎=花瓣
옷 가게=衣店
과일 가게=水果店
서점=書店
문방구=(文房)文具店
편의점=(便宜店)便利商店
슈퍼마켓=超市
싶어해요=想(第三人稱)
유명하다=有名
콘서트=演唱會
제일=(第一)最
찾다=找
그렇지만=但是
아줌마=大媽
이유=理由
으러/러=移動目的或意圖
주인=主人
치즈=起司
빨간색=紅色
파란색=青色
노란색=黃色
하얀색=白色
까만색/검은색=黑色
길다=長
짧다=短
튼튼하다=結實
약하다=弱的
두껍다=厚
얇다=薄
무겁다=重
가볍다=輕
가깝다=近
멀다=遠
치마=裙子
풀=草
코트=大衣
부르다=唱
친하다=要好的
저희=我們
자동차=汽車
보여 주다=給~看
디르다=不同
죄송하다=對不起
다시=再、重新
또=又
지만=但是
낫다=痊愈
불다=吹
부자=富有
한턱=一頓
보이다=出示
보여 주다=給~看
구경하다=看,觀賞
얼마=多少
송이=(花)朵
돕다=幫助
헤어지다=分手
설명하다=說明
대=輛
잔=杯
켤레=雙
식빵=麵包
신발=鞋子
개=個
마리=條
자루=支
벌=件
권=本
장=張
병=瓶
통=盒/封
끄다=關(開關)
켜다=開(開關)
가르치다=教
셔츠=襯衫
티셔츠=T-shit
고양이=貓
슬리퍼=拖鞋
빌리다=借
닫다=關起來(東西)
열다=開
받다=接受
고르다=選
스웨터=毛衣
바나나=香蕉
귤=橘子
앞치마=圍裙
고량주=高粱酒
비밀 번호=密碼
기르다=養
자루=支
번=(號)次
새=鳥
바퀴벌레=蟑螂
깎다=削減
발=束
상품권=(商品卷)禮卷
인형=(人型)玩偶
곰=熊
화장품=化妝品
향수=香水
액세서리=飾品
만년필=(萬年筆)鋼筆
에게/한테=給,對,向
께=給,對,向(敬)
돌아가다=回去
넥타이=領帶
권리=權利
자리=坐位
함=力氣
결혼식=婚禮
프로그램=節目
여러 가지=各種
먼저=先
한복=韓服
넥타이핀=領帶夾
피곤하다=累
목걸이=項鍊
목=喉嚨
선글라스=太陽眼鏡
걸다=掛
귀걸이=耳環
질문하다=(質問)問
어깨=肩膀
실례=打擾一下
길=路
묻다=詢問
아파트=公寓
출고=出口
동물원=動物園
오른쪽=右邊
왼쪽=左邊
계속=繼續
건너편=對面
건너다=過
횡단보도=人行橫道
육교=天橋
지하도=地下道
샌드위치=三明治
호텔=飯店,賓館
신문사=新聞社
미술관=美術館
대사관=大使館
똑바로=筆直
여관=旅館
민박=(民泊)民宿
수술실=手術室
방향=方向
동문=東門
북문=北門
서문=西門
남문=南門
기숙사=(寄宿舍)宿舍
오피스텔=套房
원룸=One room雅房
으로/로=表示移動方向或目的地
넣다=放入
놓다=放下
두다=放置
야채=蔬菜
씻다=洗
걷다=走路
보내다=寄
샤워하다=洗澡
돌려주다=歸還
얼마나=多少、多久
걸리다=需要,消耗(時間)
호선=線路
교통=交通
시내버스=市内巴士
고속버스=高速巴士
마을버스=鄉下巴士
일반택시=普通計程車
모범택시=模範計程車
기차=火車
자전거=自行車
비행기=飛機
배=船
비디오=視頻,錄像機
이메일=電子郵件
연락=聯繫
늦다=晚、遲到
밀리다=堵(車),堆積
아르바이트=兼職
호수=湖水
빨리=快
오래=久、長期
곳=地方
교통수단=交通工具
떠나다=離開
으로/로=助詞,表示方式、原因、資格
에서~까지=從～到
비키다=讓開
조심하다=小心
공항=機場
고속버스 터미널=高速巴士客運站
갈아타다=換乘
도착하다=到達
문장=(文章)句子
교통편=交通工具
펜박=簡易旅館
콘도=公寓
회=(膾)生魚片
만지다=摸
찍다=拍(照)
담배=菸
피우다=抽
주차하다=(駐車)停車
떠들다=吵鬧
더=更
지각하다=(遲刻)遲到
금연=禁煙
무르다=不知道
안내 방송=(案內外送)火車站"廣播"
걱정하다=擔心
실례하다=抱歉,失禮
박물관=博物館
목적지=目的地
비용=費用
기타=其他
으니까/니까=原因、理由(主觀)
지 말다=別,不要
건물=(建物)建築
기사=司機
걷다=走
세우다=停
출발하다=出發
도착하다=到達
사거리=十字路口
신호등=紅綠燈
직진=直走
좌회전=左轉
우회전=右轉
다르다=別
빠르다=快
모시다=帶(人)(敬)
데리다=帶(人)
가지다=帶(物)
동=棟、座
믿다=相信
얻다=得到
싣다=裝載
짐=行李
심장병=心臟病
공주병=公主病
담요병=糖尿病
감기에 걸리다=(感氣)得到感冒
차=茶
놀이터=遊樂場
이따가=等一下
전화번호=電話號碼
국제전화=國際電話
시외전화=(市外)長途電話
휴대전화=(攜帶)行動電話
핸드폰=手機
범죄=犯罪
화재=火災
신고=舉報
불이 나다=著火
나중=以後、後來
주말=週末
고속전철=高鐵
열쇠고리=鑰匙鏈
여보세요=喂
여행사=旅行社
바로=就、馬上
괜찮다=沒關係
전화를 걸다=打電話
전회를 받다=接電話
전화번호를 누르다=按號碼
신호가 가다=有信號
전화벨이 울리다=電話鈴響
잘못=錯誤
켜다=打開
휴대전화를 끄다=關手機
문자메시지를 보내다=發簡訊
문자메시지를 확인하다=查看簡訊
음성메시지를 남기다=留言
바꾸다=換
때르릉=叮鈴鈴
주소=地址
호=號
주문하다=預約
오래=久、長期
배달=送、投遞
부탁=拜託、請求
무역=貿易
웬일이세요?=有什麼事嗎？
정말=真的
는데요,은데요/ㄴ데요=表示說話人敘述某狀況,並期待得到回應
늦다=晚、遲到
약속하다=約定
장소=場所
약속을 어기다=毀約
약속을 지키다=守約
눈=雪
눈사람=雪人
세일=Sale降價
수영장=(水泳)游泳館
새롭다=新的
신발=鞋子
빌리다=借
물으세요=請問
사귀다=交往
열심히=努力
출구=出口
알리다=告知
자르다=剪
머리가 길다=頭髮長
헤어져=分手
벌다=賺
일찍=早
엔자나=總是
으면/면=如果
에게서/한테서=從,表示某動作或狀態的出發點
아직=還
아마=也許、可能、恐怕
통화하다=通話
전화를 끊다=掛電話
통화 중아다=通話中
코미디=喜劇
포도=葡萄
출장=出差
을/ㄹ 거예요=(第一二人稱)意志或打算(三)推測
만=用於名詞後,表只、僅僅
운전하다=開車
결혼하다=結婚
을게요/ㄹ게요=表示說話人的意志、誓言或決定
이나/나=或,表示羅列兩個或以上的事物選一個
달러=美元
새롭다=新的
외우다=背誦
알리다=告知
자르다=剪
틀려요=錯
표시=表示
봄=春天
계절=季節
스키=滑雪
스키장=滑雪場
되다=變成~的時候
생각=主意,想法
가난하다=窮
가을=秋天
딸기=草莓
개나리=迎春花
진달래=杜鵑花,金達萊
귤=橘子
수박=西瓜
휴가=休假
방학=放假,假期
감=柿子
단풍=紅葉
피다=開,綻放
비빔냉면=拌冷麵
한가하다=閒
도시=(都市)城市
스케이트=溜冰
태권도=跆拳道
피아노=鋼琴
치다=彈(琴)
밤길=夜路
사계절=(四季節)四季
등산하다=(登山)爬山
바람이 불다=颳風
의=~的
취미=(趣味)愛好,興趣
생활=生活
벚꽃=櫻花
눈이 오다=下雪
군요=呢啊
는데,은에/ㄴ데=表對立、轉折,但是。
을/ㄹ 수 있다=有~的能力,能夠
될 수 있으면=如果可以的話
야근=(夜勤)加班
박사=博士
뭐든지=不管是什麼
연극=(演劇)戲劇
하늘=天空
구름이 끼다=多雲
맑다=晴
개다=晴天
흐리다=陰
안개가 끼다=有霧
비가 오다/내리다=下雨
비가 그치다=雨停
눈이 오다/내리다=下雪
눈이 그치다=雪停
바람이 불다=颳風
바람이 강하다=強風
바람이 약하다=微風
신혼여행=新婚旅行
인터넷=互聯網
예매=(豫買)預購
후=之後
양말=(洋襪)襪子
신다=穿
외출하다=外出、出門
화장하다=化妝
잠옷=睡衣
밤=夜
아내=妻子
아들=兒子
딸=女兒
전남=(全南)全羅南道
생활 날씨=有關天氣的生活咨資訊
우산=雨傘
준비하다=準備
실내=室內
일기예보=天氣預報
남쪽=南部,南方
지방=(地方)地區,地方
출근=(出勤)上班
빨래=洗,(要洗的)衣物
전국=全國
낮=白天
은/ㄴ 후에=以後,之後
겠=表示說話人的推測
보다=比,前面是被比較的對象
도=度(溫度單位)
선선하다=涼爽
쌀쌀하다=涼颼颼
키=身高
습하다=潮濕
바닷가=海邊
장마철=梅雨季
눈싸움=雪仗
을/ㄹ 것 같다=應該,將要發生事情的推測
등산=登山
수영=(水泳)游泳
소풍을 가다=(逍風)去郊遊
꽃구경을 가다=去賞花
피서를 가다=(避暑)去避暑
해수욕장=海水浴場
야영을 하다=去野營
독서하다=(讀書)閱讀
단풍 구경을 가다=去賞紅葉
눈사람을 만들다=堆雪人
눈싸움을 하다=打雪仗
스키를 타다=滑雪
나이=年齡
무게=重量
목=脖子
길이=長度
편=篇,部
출연료=片酬,演出費
모래=沙子
짓다=建造,造
요즘=最近,這幾天
는군요/군요=表示感嘆、評價或判斷
고 있다=用於動詞後,表示正在進行
이해하다=理解
웃다=笑
인구=人口
억=億
평균수명=平均壽命
세=歲(表示年齡)
가난하다=窮
야근=(夜勤)加班
느리다=慢
눈가=眼眶
훨씬=更加、甚
철새=候鳥
싸우다=打架
높다=高
낮다=矮
손톱깎이=指甲刀
조깅하다=慢跑
모래시계=沙漏
서핑하다=Surfing衝浪
헬스장=健身房
초=初
끝나다=結束
공휴일=公休日
휴일=(休日)休息日
연휴=(連休)連休
방확=放假,假期
휴가=休假
계획이 없다=沒有計劃
계획을 세우다=訂計劃
계획이 있다=有計劃
이제=現在
설날=季節
중학교=中學
사귀다=結交,交往
되다=成為
비자=(Visa)簽證
필요하다=(必要)需要
동안=期間
학기=學期
숙박=住宿
준비물=準備物品
등산화=登山鞋
밀리다=堆積
이곳저곳=到處,各處
틈틈이=一有空,得空
휴가철=假期
방문=訪問
그러니까=所以,那麼
아니면=或者
으려고/려고 하다=用於動詞之後,表示計劃或意圖
동안=期間,用於表示時間段後
주로=主要
중=~當中
제일=最
영화 보다=看電影
영화 감상=電影欣賞
음악 듣기=聽音樂
음악 감상=音樂欣賞
독서=閱讀,讀書
책 읽기=讀書
사진 찍기=拍照
낚시=釣魚
바둑=圍棋
컴퓨터 게임=電腦遊戲
요리=料理
노래방=KTV
때=~的時候
우울하다=憂鬱
강=江,河
책방=書店
경치=(景致)景色,風景
을/ㄹ 때=的時後,動作狀態發生的時間
중에서=~當中
슬프다=悲傷
어렵다=難
예매하다=購物
편하다=方便,舒服
공포 영화=恐怖片
액션 영화=動作片
코미디 영화=喜劇片
전쟁 영화=戰爭片
만화 연화=動畫片
멜로 영화=愛情片
공상 과학 영화=科幻片
무섭다=害怕
너무=過於,太
귀엽다=可愛
로봇=機器人
세상=世上,世界
총=槍
칼=刀
주인공=主人公
예약하다=預約、預定
음악회=音樂會
축구=足球
경기=(競技)比賽、景氣
외식=(外食)到外用餐
감동적=令人感動的
아이=孩子
병=病
때문에=因為~
병에 걸리다=生病
죽다=死
꼭=一定
울다=哭
배우=演員
감독=導演、教練
에~쯤=差不多、大概
못=不能,不能夠
탁구를 치다=打乒乓球
마다=每
별로=不太,不怎麼
야구=棒球
농구=籃球
배구=排球
골프=高爾夫
테니스=網球
당구=撞球
배드민턴=羽毛球
스노보드=單板滑雪
치다=打,擊
공=球
사용하다=使用
팀=組,隊
샤워를 하다=洗澡
머리를 감다=洗頭髮
모니터=顯示器、監視機
거나=或者
조사=調查
활동=活動
보내다=過(時間)
방법=方法
집안일=家務
스포츠=運動
관광지=(觀光地)旅遊區
놀이공원=遊樂園
온천=溫泉
기 전에=~之前
지 못하다=不能夠
미역국=海帶湯
와이셔츠=襯衫
소설책=小說
시집=詩集
손끝=指尖
머리부터 발끝까지=從頭到腳
빨간 날=見紅修
설연휴=過年連休
설저=春節
정답=(正答)答案
하루종일=(一天終日)一整天
응원하다=應援
취업하다=就業
숨다=躲
피하다=避開
당기다=拉
밀다=推
일단=一旦
연락하다=聯絡
무용=(舞踴)舞蹈
마작=麻將
인조인간=(人造人間)複製人
기회=機會
악마=惡魔
디저트=甜點
포기=放棄
서재=(書齋)書房
도망치다=逃亡
발음=發音
단어=單字
문법=文法
범인=犯人
불편하다=不方便
평일=平日
주종=(週中)週間
배역=(配役)配角
예약석=預約席
좌석=坐座
입석=站座
씩=各
알아보다=認出
알아듣다=聽得懂
잘 못=不太行、不太會
식탁=餐桌
타자를 치다=打字
정구=(庭球)網球
