안녕=你好；再見
예=是的
아니요=不是的
해요=做
환영해요=歡迎
부탁합니다=請~ (禮貌用語)
미안해요=對不起
오케이=好的；OK
고마워요=謝謝
갑시다!=我們走吧！
합시다!=我們幹吧！
건배!=乾杯！
어떻게=怎樣；如何
지내요=過 (得~)；生活 (得~)
요즘=最近；現在
요즘 어떻게 지내요?=你最近好嗎？
나=我
당신=你 (單數)
정말=非常；真的 (很~)
잘=好；好好地
~은=主題虛詞
~는=主題虛詞
나는 정말 잘 지내요=我很好
뭐=什麼
무슨=什麼
이름=名字
내=我的
당신의=你的
~이에요=是~
~예요=是~
당신의 이름은 뭐예요?=你叫什麼名字？
내 이름은 ~예요=我的名字是~
천재=天才
당신은 정말 천재예요!=你真是個天才！
무슨 일이에요?=怎麼了？ ；怎麼樣？
나중에=晚些時候；待會兒
봐요=看見；看；觀看
나중에 봐요=待會兒見；再見
나쁜=壞的
좋은=好的；親切的
아침=早上；早晨
좋은 아침이에요=早上好
밤=夜晚；晚上
보내요=花費；花 (時間)
좋은 밤 보내요=晚安
배고프다=(感到) 飢餓
배고파요=~ (肚子)餓了
목마르다=(感到) 口渴
목말라요=~口渴了
슬프다=(感到) 悲傷
화나다=(變) 氣憤；生氣
아프다=生病；傷害
틀리다=錯誤的
옳다=正確的
하다=(去)做
행복하다=(感到) 快樂；(感到) 幸福
피곤하다=(感到) 累
나는 피곤해요=我累了
당신은 아파요=你生病了
배고파요?=你餓了嗎？
내가 틀렸어요?=我錯了嗎？
당신이 맞아요=你是對的
음식=食物；食品
김치=泡菜
국수=麵條
빵=麵包
파스타=意大利面
밥=米；飯
비빔밥=石鍋拌飯
감자=土豆
채소=蔬菜
과일=水果
고기=肉
삼계탕=參雞湯
샐러드=沙拉
사과=蘋果；道歉 (名詞)
바나나=香蕉
오렌지=橘子；橙子
레몬=檸檬
간식=零食
불고기=韓國烤肉
수프=湯
달걀=蛋；雞蛋
치즈=奶酪；起司
닭고기=雞肉
돼지고기=豬肉
소고기=牛肉
생선=魚肉
물=水
커피=咖啡
차=茶
맥주=啤酒
와인=葡萄酒
우유=牛奶
주스=果汁
소스=醬汁
오일=油 (烹飪)
참기름=芝麻油
버터=黃油；牛油
좋아하다=喜歡
있다=擁有；留下
먹다=吃
마시다=喝；飲用
~아요=一般現在時符號
~어요=一般現在時符號
~여요=一般現在時符號
좋아해요=喜歡
있어요=有；留下；那裡有
먹어요=吃
마셔요=喝
~지 않아요=不(做某事)；非；不要 (做某事)
좋아하지 않아요=不喜歡
먹지 않아요=不吃
마시지 않아요=不喝
없어요=沒有~
그것=它；那個
맛=味道
맛있다=美味的
역겹다=噁心的
굉장하다=令人驚嘆的；是極好的
~과=和
~와=和
차와 커피=茶和咖啡
삼계탕과 불고기=參雞湯和韓國烤肉
~을=賓語提示虛詞
~를=賓語提示虛詞
나는 빵을 좋아해요=我喜歡吃麵包
나는 오렌지를 좋아해요=我喜歡吃橘子
나는 파스타를 좋아하지 않아요=我不喜歡吃意大利面
나는 사과를 좋아하지 않아요=我不喜歡吃蘋果
그것은 정말 맛있어요=這個非常好吃
커피는 정말 맛있어요=咖啡很好喝
나는 차와 커피를 좋아해요=我喜歡喝茶和咖啡
나는 삼계탕과 불고기를 좋아해요=我喜歡參雞湯和韓國烤肉
나라=國家
한국=韓國
중국=中國
사람=人
한국 사람=韓國人
중국 사람=中國人
어느=哪一個
어디=哪裡（疑問句）
~이=主語提示虛詞
~가=主語提示虛詞
~이 아니에요=我不是；(它；他；她；他們)不是
~가 아니에요=我不是；(它；他；她；他們)不是
당신은 어느 나라 사람이에요?=你是哪里人？
당신은 중국 사람이에요?=你是中國人嗎？
예, 나는 중국 사람이에요=是的，我是中國人
당신은 한국 사람이에요?=你是韓國人嗎？
아니요, 나는 한국 사람이 아니에요=不，我不是韓國人
숫자=數字
번호=號碼
전화=電話
전화번호=電話號碼
공=零；0 (用作電話號碼時)；球
영=零；0 (漢音數字)
일=一；1 (漢音數字)；日子；工作
이=二；2 (漢音數字)
삼=三；3 (漢音數字)
사=四；4 (漢音數字)
오=五；5 (漢音數字)
육=六；6 (漢音數字)
칠=七；7 (漢音數字)
팔=八；8 (漢音數字)
구=九；9 (漢音數字)
십=十；10 (漢音數字)
전화번호가 뭐예요?=你的電話號碼是多少？
그=他
그를=他 (作賓語時加를)
그녀=她
그녀를=她 (作賓語時加를)
당신들=你們
당신들을=你們 (作賓語時加을)
우리=我們
우리를=我們 (作賓語時加를)
그들=他們
그들을=他們 (作賓語時加을)
레스토랑=餐廳
자리=座位
메뉴=菜單
계산서=賬單
나이프=刀；小刀
포크=叉子
숟가락=勺子
젓가락=筷子
주문하다=點餐；點菜
것=事情；事物
좀=一些；任何
~시=禮貌用辭
~세=禮貌用辭
주다=給；給予
주시겠어요=(請) 給
~ 좀 주시겠어요?=請問可以給~一些~嗎？
한 사람=一個人
두 사람=兩個人
위한=為了
나를 위한 것=為了我
당신을 위한 것=為了你
그것은 당신을 위한 것이에요=這是給你的
그것은 나를 위한 것이에요?=這是給我的嗎？
두 사람 자리 부탁합니다=一張兩座的桌子，謝謝
메뉴 좀 주시겠어요?=請問可以給我們菜單嗎？
계산서 좀 주시겠어요?=請問可以給我們賬單嗎？
괜찮아요=沒事；沒關係；不用了謝謝
