희망=希望
언제나=總是；無論何時
언제나 희망이 있어요=總會有希望的
기대=期待；預期
기대하지 마세요=別抱太大希望
곤경=麻煩；困難
곤경에 빠지다=遇到麻煩
우리는 큰 곤경에 빠졌어요=我們有大麻煩了
긍정적이다=積極的；正面的
긍정적인 생각들을 해요=正面思考
참다=壓制；忍耐
견디다=承受；克服
참고 견뎌요=堅持住；堅持一下
지나가다=通過；經過；過去
그것은 다 지나간 일이에요=那都是成年往事了
부서=部門
다이아몬드=鑽石
상자=箱子；盒子
증정하다=呈現；饋贈
보고하다=做報告；報告
대표하다=代表 (動詞)
담겨 있다=包含
문제를 보고했던 그 남자 ~=~報告了問題的那個男人
영화관에서 일했던 그 소녀 ~=~在電影院工作的那個女孩兒
다이아몬드가 담겨 있던 그 상자 ~=~裝鑽石的盒子
내가 오늘 아침에 썼던 그 편지 ~=~我今天早上寫的信
누나가 정부에서 일했던 그 남자 ~=~姐妹在政府部門工作的那個男人
산업=工業；產業
서비스=服務
잔액=餘額
흔들다=搖晃
악수하다=握手
머리를 흔들다=搖頭
끄덕이다=點頭
남아있다=剩下；剩餘
남아있지 않다=沒有~.了
보호하다=保護 (動詞)
받아들이다=接受
언급하다=提及；談到
결정=決定 (名詞)
결정하다=決定；做決定 (動詞)
나타내다=指示；建議
주장하다=申明；宣稱
요구하다=要求 (動詞)
단지=只是；僅僅
내 폰에 잔액이 남아있지 않다고 말했잖아요=我告訴過你我的電話欠費了
그들은 단지 아이들을 보호하고 있었다고 주장해요=他們聲稱他們只是在保護自己的孩子們
그들은 부모가 될 것이라고 말했어요=他們之前說他們就要做父母了
그는 매장이 정오에 닫혀있었다고 언급했어요=他曾提到那家店中午會關門
증거는 당신이 유죄임을 나타내요=有證據顯示你是有罪的
행정=行政；行政管理
기관=組織；機構
퍼센트=百分比
계약=合約；合同
회사=公司
기간과 조건=條款與條件
사인하다=簽字；簽名 (動詞)
성장하다=開發；發展 (動詞)
개인의=私人的
개인적인=個人的
공적인=公眾的；公開的
일반 국민=公眾
합법의=合法的；法律上的
불법의=非法的
상업적인=商業的
조금도=完全；十分
전자제품=電子產品
이메일=電子郵件
문자=短信；字母
프로그램=程序
컴퓨터 프로그램=電腦程序
엔지니어=工程師
프로그래머=程序員
화면=屏幕
버전=版本
모범=模型
과정=過程
사이트=網站
인터넷=網絡；互聯網
사회의=社會的；社交的
미디어=媒體
소셜 미디어=社交媒體
이용자=用戶
프로필=個人資料
등록하다=註冊 (在線)
로그인 하다=登陸
로그아웃 하다=退出登錄；登出
설정하다=設置；調整
게시하다=發帖子 (在社交媒體上)
데이터=數據
온라인=在線；線上
오프라인=線下；不在線
구식인=過時的
최신의=更新了的
글=文章
~에 대한 글=關於~的文章
비밀=秘密
비밀을 지키다=保密；保守秘密
인구=人口
펀드=基金；資金
권리=權利
사람의 권리=人權
출판하다=出版 (動詞)
폭로하다=揭示；揭露；顯示
지구=地球
별=星星
우주비행사=宇航員
행성=星球；行星
우주=宇宙；太空
우주선=太空飛船
외계인=外星人
탐사하다=探索 (動詞)
날아가다=飛翔；飛行
발견하다=發現 (動詞)
다르다=不同的；不一樣的
비슷하다=相似的；類似的
우주의 끝으로=宇宙的盡頭
만일 내가 날아갈 수 있었다면 나는 별에 갈 수 있었을 거예요=若我會飛，我就能到星星上去
만일 내가 우주비행사였다면 나는 우주에 갈 수 있었을 거예요=如果我是宇航員，我就可以去外太空了
만일 내가 우주선이 있었다면 나는 우주의 끝으로 날아갈 수 있었을 거예요=若我有艘太空飛船，我就可以飛到宇宙的盡頭去
이유=原因；理由
원인=原因；緣由
~인 것 같다=看起來像是~
방해=妨礙；擾亂；阻礙
방해가 되다=擋路；阻礙
그렇죠?=~，對嗎？ ；~，是不是？ ；~，不是嗎？ (一般疑問符號)
그는 별로 영리하지 않아요, 그렇죠?=他不是特別聰明，是吧？
그는 항상 방해가 돼요, 그렇죠?=他總是礙手礙腳的，不是嗎？
치료는 효과가 있는 것 같지 않아요, 그렇죠??=那種療法似乎沒什麼效果，對吧？
그는 현명한 정치가처럼 보여요, 그렇죠?=他看起來似乎是個聰明的政治家，不是嗎？
다물다=關閉
왜 입을 다물고 있어요?=啞口無言了？
억수같이=傾盆；瓢潑
비가 억수같이 내려요=傾盆大雨；瓢潑大雨
입만 살았어요=雷聲大雨點小；光說不練
로마=羅馬
통하다=領導；帶領
모든 길은 로마로 통해요=條條大路通羅馬
피는 못 속여요=有其父必有其子；虎父無犬子
과거=過去
현재=現在
미래=未來
잊어버리다=忘掉；拋下
지나간 과거는 잊어버려요=忘記過去；放下過往
당국=當局
안전=安全；安全性
안전벨트=安全帶
수사=調查；查案；盤查
인플레이션=通貨膨脹
준비하다=準備 (動詞)
고용하다=僱傭 (動詞)
해결하다=解決
향상하다=改進；增進；改良
창조하다=創造 (動詞)
야기하다=引起；造成；導致
키우다=撫養；養育 (孩子)
잔혹하다=殘忍的
극심하다=嚴峻的；劇烈的
재미를 위해=為了找樂子；好玩兒而已
말도 안 된다=荒謬的；荒唐的
최근에=最近
충분히=有效地
~에 의해=通過；依靠~
사건은 경찰에 의해 해결되었어요=這個案子警察已經解決了
병원은 당국에 의해 만들어졌어요=那間醫院是當局修建的
지위=職位
대행사=辦事處；代辦處；中介
네트워크=網絡
면접=採訪
태도=態度
능력=能力；技能；技巧
의사소통=交流；溝通
문제 해결=解決問題
빨리 배우다=學得快
이완되다=放鬆的
자신감=自信 (名詞)
책임감=責任
기회=機會；機遇
도전=挑戰
선택사항=選擇；選項
프로젝트=項目
업무=任務
경영=管理 (名詞)
경영하다=管理 (動詞)
지원하다=申請；採用
친근하다=友好的
할 수 있다=有能力；能夠
할 수 없다=沒有能力；不能夠
높이 평가하다=(對~) 評價頗高
기대하다=期待；期望 (動詞)
사회=社會
지역=周邊地區；附近；區域；地區
지역 사회=當地社區
사회보장=社會保險；社會保障
대민 업무=公務員服務；行政部門
요금=收費；費用
예산=預算
소유자=所有者；主人
재산=財產
재산 소유자=財產的所有者
조합=聯盟；聯合會
개혁=改革
이점=優勢
단점=劣勢
교통수단=交通；運輸
재정=財務；財政
공장=工廠
근로자=工人
파업하다=罷工
허락하다=允許；許可
허락되다=被允許
선배=前輩
후배=晚輩；後輩
장교=長官
병력=兵力；軍隊
무서움=恐懼
리포트=報告
운동=運動
위협=威脅 (名詞)
협박하다=威脅 (動詞)
훈련=訓練 (名詞)
계획하다=計劃 (動詞)
처리하다=處理；解決 (某事)
강요하다=強迫 (動詞)；勉強
육체의=身體；肉體
조심하다=小心的；謹慎的
제품=產品
생산=生產 (名詞)
생산하다=生產 (動詞)
제공하다=服務；提供；供應 (動詞)
항목=物品；東西
조각=(一) 片
범위=範圍
총액=數量；量
재고=庫存
재고로=有庫存；有存貨
사이즈=大小
재료=材料
스타일=風格
마침표=句號；休止符號
플라스틱=塑料
패턴=模式；形式
디자인=設計 (名詞)
디자인하다=設計 (動詞)
특정하다=特定的；指定的
구체적이다=具體的；
세부사항=細節
국가=國家
시민=公民；國民
자유=自由
다수=大多數
소수=少數
연설=演講；講話 (名詞)
합의=意見一致；同意
주소를 쓰다=寫地址
매년=一年一度的；每年
국가의=國家的；國內的
국제적인=國際的
세계적인=全球的
토론하다=商量；討論
강조하다=指出；強調
설득력 있다=有說服力的
전통적=傳統
현실=現實
구획=區域；區劃
역할=角色
사제=牧師；神父
타이어=輪胎
불=火；火焰
열기=熱量；熱度
남은 음식=剩飯；剩菜
정상=頂部；最上面
수집품=收藏品；收集
변화=變化；改變
엔진=引擎；發動機
기계=機器；機械
기준=標準
공연=演出；表演 (名詞)
수행하다=表演 (動詞)
적군=敵人
입장=立場
우선 사항=優先選擇
재난=災難
행동 방침=行動方針
방어=防禦
전략=戰略；策略
자원=資源
임무=任務
목적=目的；目標
유용하다=有目的的；為了某個目的
~이 적어지다=逐漸減少；逐漸降低
~ 다 써버리다=用完~
시간 안에 해내다=趕上 (時間)
극복하다=撐過去；克服；戰勝
완료하다=完成 (動詞)
만일 당신이 그곳에 있었다면 당신도 그 이야기를 들었을 거예요=如果你當時在場，也會聽到那個故事
만일 우리가 더 많은 달걀을 샀었다면, 우리는 케이크를 만들 수 있었을 거예요=要是我們之前買了雞蛋的話，現在就可以做蛋糕了
만일 당신이 그곳에 있었다면 나는 당신의 입장 역시 들었을 거예요=你當時如果在場，我就能聽聽你對此事的說法了
만일 당신이 단지 문자만 했었다면 나는 그렇게 걱정하지는 않았을 거예요=要是你當時能留張便條，我也不會如此擔心了
만일 그가 그의 문제들을 처리했었다면 그는 괜찮았을 거예요=如果他之前把自己的問題處理好了，現在就會沒事了
조사하다=調查；搜索 (動詞)
분석=分析 (名詞)
분석하다=分析 (動詞)
접근법=途徑；方法
방법=方法
논거=論據
개념=概念
아이디어=注意；點子
학회=會議
과학자=科學家
참가자=參加者
요인=因素；原因
지식=知識
비교하다=比較；做比較 (動詞)
테스트하다=測試 (動詞)
비판적=批評；批判
무작위=隨機性；
효과적=效用；有效性
그룹=小組；組織
개인=個人；單個
논리적이다=有邏輯的
비논리적이다=沒有邏輯的
원래의=原來的；本來的
기본의=基本的
이론상으로=理論上
실제로=在實踐中；實際上
일반적=一般性；概論
곧장=直接地
극적으로=戲劇性地；誇張地
전적으로=絕對地；完全地
특별하다=特別的；特殊的
제시간에=準時
남는다=備用的；額外的
정확히=準確地；確切地
오랫동안=很長的時間；很久很久
표면=表面
외견상으로=(在) 表面上
단순하게=只是；根本；簡單地
틀림없이=當然地；肯定地
결국=最終；結果；終於
최고경영자=CEO；首席執行官
파트너=合作夥伴
이사회=董事會
회사 임원=董事會成員
고용인=僱員；員工
경비=成本；開銷 (複數)
수입=收入
소비자=消費者
발달=發展
투자=投資
이익=利潤；盈利
손실=虧損；減少
10년=十年；十年期
성취하다=達成；獲得
포함하다=包括
제외하다=除去；排除
쥐=老鼠
활동=活動；事情
시리즈=連續的；系列；連續
방향=方向
나머지=剩下的；其他的
기억=記憶
추억=回憶 (美好的記憶)
건축물=建築物
바위=岩石
접근=通路；訪問；進入的許可
공무원=官員；公務員
가스=天然氣；煤氣
언론=新聞界；輿論
기자회견=新聞發布會
원천=源頭；資源
발송자=發送者
정보=信息
이벤트=活動；事件
지원=支持
계좌=賬戶
캠페인=活動；公眾活動
캠페인을 운영해요=組織一個活動；進行一項活動
세대=世代
경향=趨勢
경향이 있다=趨向於
전화를 끊다=掛掉電話
전화를 받다=接電話
찾아내다=找出來；查出來
영향을 미치다=影響 (動詞)
발생하다=發生 (動詞)
알아차리다=注意到；通知 (動詞)
관련시키다=與~關聯；相關 (動詞)
예방하다=防止；預防 (動詞)
인정하다=承認 (動詞)
정치적인=政治；政治上的
서로에게 좋은 상황이에요=這是個雙贏的局面
징크스가 있다=使倒霉；帶來厄運
생기다=形成；發生
징크스 생기지 마세요=別烏鴉嘴
참=真的；真實地
참 운도 없군요=壞運氣；倒霉
태우다=燃燒；燒
~으로 변하다=變成~；轉變為~
~에 대하여 걱정하다=擔心~
존재하다=存在 (動詞)
채우다=填滿；裝滿
형성되다=形成 (動詞)
응시하다=盯住；凝視
조직하다=組織 (動詞)
두다=放置 (動詞)
자르다=切；砍
눈에 띄다=出現；顯現 (動詞)
타고나다=出生
참 잘했어요!=做得很好！ ；幹得漂亮！
너 해냈구나!=你 (把這事兒) 搞定了！
너는 최고!=你是最棒的！
