신나다=激動的；興奮的
재미=好玩；趣味
재미있다=好玩的；有趣的
지루하다=無聊的
제가 ~면 어떨까요=我可以 (提出建議)
그것은 굉장할 거예요=那會很棒！
당신은 오늘 밤에 영화를 볼 거예요?=你今晚會看電影嗎？
우리 영화관에 가면 어떨까요=我們可以去電影院
그는 오늘 오후에 박물관에 갈 거예요=他今天下午要去博物館
당신은 언제 떠날 거예요?=你什麼時候離開？
우리는 나중에 말할 거예요=我們晚點再聊
파티=派對；慶祝
클럽=俱樂部；會所
나는 정말 ~ 하고 싶어요=我很願意~；我想要~
취하다=喝醉酒；採取 (動詞)
휴식을 취하다=放鬆
술 마시러 가다=去喝點酒
잠들다=睡著 (的)；沉睡
깨어나다=醒來
깨어있다=醒來的；清醒
잠자러 가다=(去) 睡覺
일어나다=起床；發生
함께 시간을 보내다=一起玩；花時間在一起
모두=每個人
아무도=沒有人
어떤=什麼；哪一個；一些；任何
어떤 사람=某人；任何人
함께=一起
나와 함께=和我
당신과 함께=和你
그냥=只是；就那樣
~고 나서=然後
당신은 아침에 뭐 하는 것을 좋아해요?=你早上喜歡做什麼？
나는 달리고 나서 샤워하는 것을 좋아해요=我喜歡去跑步然後淋浴
우리 오늘 그냥 쉬면 어떨까요?=我們今天可以休息
나와 함께 파티에 가고 싶어요?=你想和我一起去參加派對嗎？
나도 정말 가고 싶지만 나는 내일 일찍 일어나야 해요=我很願意去，不我明天要早起
아무도 나와 함께 시간을 보내고 싶어 하지 않아요=沒人想和我一起玩
왜 안돼요?=為什麼不呢？
마지막=最後；最終
어젯밤=昨晚
두 달 동안=兩個月的時間
삼 주 전=三個星期前
~았어요 (~었어요; ~였어요)=過去時態符號
나는 도왔어요=我幫助過
나는 먹었어요=我吃了；我吃過
나는 원했어요=我曾想要
나는 어제 아빠를 도왔어요=我昨天在廚房幫爸爸幹活兒了
우리는 이 주 동안 기다렸어요=我們等了兩個星期
나는 일본에서 두 달 동안 공부했어요=我曾在日本學習過兩個月
우리는 어제 스타터 4개를 주문했어요=我們昨天點了四道開胃菜
그들은 지난주에 독일을 여행했어요=他們上週去了德國旅遊
그들은 중국에서 팔 년을 살았어요=他們曾在中國生活過八年
나는 그를 사랑했어요=我曾愛過他
그는 한국어를 정말 잘 했어요=他的韓語說得非常好
우리는 어젯밤에 맥주를 너무 많이 마셨어요=我們昨晚喝了太多啤酒
그는 그 차를 이십 년 전에 샀어요=他二十年前買了那輛車
우리는 택시를 탔어요=我們搭了出租車
나는 이 년 전에 책을 썼어요=我兩年前寫過一本書
그들은 우리와 함께 저녁을 먹지 않았어요=他們沒和我們一起吃晚餐
나는 어제 그녀를 도서관에서 봤어요=我昨天在圖書館看見她了
대화=對話；交談
주제=主題
관계=關係
날씨=天氣
정치=政治
기술=科技；技術
사랑=愛情；愛
연애생활=戀愛生活
과학=科學
~에 대해=關於
~에 대해 말하다=告訴關於~ (的事)；講述關於~
프랑스 사람들은 음식에 대해 말하는 것을 정말 좋아해요=法國人喜歡聊吃的
그들은 보통 날씨에 대해 말해요=他們通常都聊天氣
나는 내 연애생활에 대해 말하고 싶지 않아요=我不想討論有關我戀愛的事情
문화=文化
말다툼=爭論；爭吵 (名詞)
싸우다=爭論；爭吵 (動詞)
토론=討論；辯論
궁금하다=好奇的
부끄럽다=尷尬的
무서워하다=害怕的
긴장되다=緊張的
흥미롭다=有趣的
중요하다=重要的；重大的
만들다=製作；建立
그는 연애생활에 대해 말하는 것을 부끄러워해요=談論有關他戀愛的事情讓他很尷尬
우리 아빠는 기술에 대해 아무것도 몰라요=我們父親對科技一竅不通
우리는 그들에게 그 말다툼에 대해 말해야 해요?=我們應該把那件吵架的事告訴他們嗎？
핵심=觀點；論點；重點
핵심이 뭐예요?=重點是什麼？
계획이 뭐예요?=計劃是什麼？
그것을 이해했어요?=那樣能理解嗎？
지금 뭐 생각하고 있어요?=你現在在想什麼？
고대=估計；預期
고대하다=期待~；預料~
우리는 당신 보는 것을 고대하고 있어요=我們很期待見到你
우리는 당신 만나는 것을 고대하고 있어요=我們期待與你會面
바보=傻瓜
굴다=行動；行為舉止 (動詞)
바보처럼 굴지 마!=別像個傻瓜一樣！
차분하다=冷靜的
진정하다=冷靜下來
진정하세요=冷靜下來 (禮貌用語)
조용히 하세요=請安靜 (禮貌用語)
씨름=摔角 (韓國傳統摔角)
축구=足球
배드민턴=羽毛球
농구=籃球
야구=棒球
아이스하키=冰球
골프=高爾夫球
체조=體操
권투=拳擊
테니스=網球
크리켓=板球
보트=船；划船
낚시=釣魚
범죄=罪行；犯罪
처벌=懲罰
소설=小說
범죄소설=偵探小說；犯罪小說
스릴러=驚悚片
다큐멘터리=紀錄片；實錄
코미디=喜劇
픽션=虛構小說
드라마=戲劇；連續劇
정원=花園
가꾸다=種；培育
정원을 가꾸다=做園藝；照看花園
노래=歌唱；歌曲
노래하다=唱歌；唱
더 좋아해요=更喜歡
종류=種類；類型
어떤 종류의 ~ ?=什麼樣的~？
당신의 친구는 코미디를 좋아해요?=你朋友喜歡看喜劇嗎？
그녀는 스릴러를 더 좋아해요=她更喜歡看驚悚片
나는 농구하는 것을 좋아해요=我喜歡打籃球
그녀는 배드민턴도 좋아하지만 씨름을 더 좋아해요=她也喜歡打羽毛球，但是她更喜歡傳統韓式摔角
당신의 친구는 어떤 종류의 영화를 더 좋아해요?=你朋友喜歡看什麼類型的電影？
나는 드라마도 좋아하지만 코미디를 더 좋아해요=我也喜歡看電視劇，但我更喜歡喜劇
움직이다=移動
퇴직하다=退休
그만두다=放棄；退出
스키 타러 가다=去滑雪
외국=國外；外國
외국에 가다=去國外；出國
다니다=(常) 去
꽤=很；十分
여전히=仍然；依舊
보통=通常
월요일마다=每個星期一
두 시간 안에=兩個小時之內
약 삼 년 안에=大概三年之內
당신의 가족에 대해 말해주세요=跟我講講你的家人
우리는 겨울에 보통 외국에 가요=我們通常會在冬季的時候去國外
그녀는 오 년 전에 꽤 좋은 직장이 있었어요=五年前她曾有一份相當不錯的工作
우리 부모님은 약 삼 년 안에 퇴직을 할 거예요=我們的父母將會在大概三年內退休
제 조부모님께서는 여전히 스키 타러 다니세요=我的爺爺奶奶現在依然會去滑雪
우리는 수요일마다 여전히 함께 축구를 해요=我們每週三還是會一起踢足球
