멤버=成員
팬=迷；粉絲 (支持者)
팬클럽=(球；歌；影等)迷俱樂部
스포츠 클럽=體育俱樂部
시즌=季節；賽季
토너먼트=錦標賽
리그=聯賽；聯隊；聯盟
챔피언십=冠軍賽
시작하다=開始
끝내다=完成；結束
비기다=平局；平分
지지하다=支持
시즌은 항상 8월에 시작해요=賽季一般是從八月份開始
나는 팬클럽의 멤버가 되고 싶어요=我想加入 (球)迷俱樂部
만약 그들이 이번 경기에 우승한다면 리그 우승이에요=他們如果贏得這場比賽，季賽也會贏的
당신은 어느 팀을 지지해요?=你支持哪支球隊？
선택=選擇
현명하다=有智慧的；明智的
그것은 현명한 선택이었어요=那是一個明智的選擇
당연하다=自然的
그것은 당연한 선택이었어요=這是自然而然的選擇
그것은 내 최고의 선택이었어요=那是我的優先選擇
가격=價格
가치=價值
질=質量
합당하다=適當的；恰當的
그것은 가격에 합당한 가치가 있어요=物有所值
시기=時間；期間；階段
지금은 어려운 시기예요=這段時間很艱難
그런 것 같아요=我估計是這樣
견해=見解
차이=區別；差異
이것은 견해 차이예요=這是個人看法的問題
능력=能力；技能；技巧
미치다=到達；抵達；發瘋
내 능력이 미치는 한=盡我所能；竭盡全力
무슨 일이 있어도=不惜一切代價
수준=標準
안 맞다=不合適~；不符合~
이것은 당신의 수준에 안 맞아요=這不是你該做的事
손바닥=手掌
손바닥을 마주치다=雙掌合十；合掌
소리가 난다=發出聲音；發出響聲
손바닥도 마주쳐야 소리가 난다=一個巴掌拍不響
쉽게=容易地；輕易地
쉽게 얻은 것은 쉽게 잃는다=來得容易去得快
자업자득=善有善報，惡有惡報
모르는 것이 약이다=無知是福
경험은 최고의 스승이다=經驗是最好的老師
사실이다=真實的；真誠的
거짓이다=虛假的；假的
거짓말하다=撒謊
동의하다=同意
좋다=好的；良好的
공평하다=公平的
불공평하다=不公平的
어리석다=傻的；蠢的
그냥 나에게 말해주세요=跟我聊聊吧
우리는 동의하지 않아요=我們不同意
나는 당신에게 동의하지 않아요=我不同意你 (的看法等)
그녀는 절대 내 말을 듣지 않아요=她從來不認真聽我說話
이것은 공평하지 않아요=這不公平
나에게 거짓말하지 마세요=別對我撒謊
이것은 정말 불공평해요=這太不公平了
이것은 그냥 어리석은 다툼일 뿐이에요=這是一場愚蠢的爭吵
법과 질서=法律與規則
알아보다=認識；認出
묘사하다=形容；描述
그림을 그리다=畫畫
가리키다=指；指出；指示
가운데에=在中間
왼쪽에=靠左邊；向左邊
오른쪽에=靠右邊；向右邊
~거나=要么~要么~；是~或者~
~도 ~도 아니다=既不~也不~
이것은 명령이다!=這是命令！
내가 생각하기에 그는 왼쪽에 그 남자였어요=我認為是靠左邊的那個男人
당신은 그의 그림을 그릴 수 있어요?=你能畫一幅他的肖像畫嗎？
묘사하거나 그림으로 그려요=要么描述一下，要么畫下來
그 여자를 묘사하거나 그림으로 그려요=描述一下那個女人，或者把她畫下來
당신은 그 여자를 묘사하거나 그림으로 그릴 수 있어요=你可以描述一下那個女人，或者把她畫下來
충고=建議
메시지=信息
주목하다=注意 (某事或某人)
불평하다=抱怨；訴苦 (自己)
잊다=忘記；遺忘
그만하다=停止；取消；阻止
나 자신=我自己
당신 자신=你自己
그 자신=他自己
내가 충고 좀 해도 될까요?=我能給你提些建議嗎？
너는 그를 정말 잊어야 해=你應該把他忘了
너는 그를 용서해야 해=你應該原諒他
그녀는 어떤 사람에게도 말하지 말아야 해요=她不應該告訴任何人
나는 내 남자친구를 정말 용서해야 할까요?=我應該原諒我的男朋友嗎？
걱정 그만해요=別再擔心了
직시하다=面對
~ 사실을 직시합시다=讓我們面對~
깨닫다=意識到
나는 ~ 갑자기 깨달았어요=我突然意識到~
조건=條件
한 가지 조건하에 ~=有一個條件~
고려하다=考慮
모든 것을 고려해 볼 때 ~=從全面考慮~；總地來說~；考慮到所有因素~
공개적으로 ~=作為參考~；作為記錄~
비공개=非公開 (的)
이것은 비공개예요=這個是非公開的
현대의=現代的
현대 세상=現代世界；當今世界
현대 세상에는 ~=在現代世界中~
끄다=關閉；關掉；關上
켜다=打開；開啟
높이다=提高；增強
낮추다=降低；減弱
가능성이 있다=有機會~；有~的機會
티브이를 끄다=關上電視
낮다=低的；低處的
높다=高的；高處的
내 형의 팀은 우승할 가능성이 꽤 높아요=我兄弟的隊很可能會贏
그들은 아마도 리그에서 우승할 거예요=他們或許可以贏得聯賽
내가 생각하기에 우리팀은 내일 우승할 거예요=我覺得我們隊明天會贏
살인=謀殺；殺人；兇殺
살인범=殺人犯；兇手
죽이다=殺；殺死
강도=強盜；搶劫犯
사건=案件；案子
강도 사건=搶劫 (案件)
털다=搶；搶劫 (動詞)
희생자=受害者
용의자=嫌疑犯
목격자=目擊者；目擊證人
총=槍；手槍
마스크=面具；面罩
마약=麻醉藥；毒品
거래하다=交易 (動詞)
무기=武器；凶器
살인 무기=殺人凶器
주머니=口袋
찌르다=捅；刺；戳
쏘다=射擊
잡다=捉住
대낮에=青天白日；光天化日
현행범=人贓俱獲；抓個現行；當場
그것은 강도 사건이었어요=這是一起搶劫 (案件)
그것은 살인이었어요=這是一起謀殺 (案件)
목격자는 용의자를 봤어요=目擊者看到了疑犯
그는 대낮에 은행을 털었어요=他在光天化日之下搶劫了銀行
경찰은 살인범을 현행범으로 잡았어요=警察當場捉住了殺人犯
유감스럽게도 경찰은 살인 무기를 발견할 수 없었어요=遺憾的是，警察沒能找到殺人凶器
들판=田地；農田
나무=樹
식물=植物
폭포=瀑布
강=河流
도로=道路；馬路
표지=標識
도로 표지판=路標
길을 잃다=走丟；迷路
사라지다=消失
안으로=到~裡；成為~狀況
향하여=朝著；向著
마침내=最後；終於
나는 ~기를 바란다=我希望~
나는 ~라고 말했어요=我說~
걸어가다=走路；散步 (動詞)
들어가다=進入；進去~裡面
걸어 들어가다=走進~
우리는 정글 안으로 걸어 들어갔어요=我們走進了叢林
우리가 길을 잃지 않기를 바란다=我希望我們別迷路
내 남편은 "우리가 길을 잃지 않기를 바란다"라고 말했어요=我老公說：“我希望我們別迷路”
갑자기 우리 여행 가이드가 사라졌어요=忽然，我們的導遊不見了
우리는 폭포를 향하여 걸어가려고 했지만, 그것은 너무 위험했어요=我們試過朝著瀑布走，但那實在太危險了
마침내 우리는 도로 표지판을 찾았어요=最後我們終於找到了路標
우리는 강을 따라갔기 때문에 길을 잃지 않았어요=我們沒有迷路是因為沿著河走
산들바람=微風
땅=地；土地
선탠로션=防曬霜
장화=長筒雨靴
강풍=大風
같다=(是) 一樣的
~을 것 같다 (~ㄹ 것 같다)=和~一樣
강풍의 위험이 있었어요=有可能會刮大風
햇빛이 날 가능성이 있어서 우리는 선탠로션을 가져왔어요=有可能會出太陽，所以我們帶了防曬霜
내일 비가 올 것 같기 때문에 그들은 비옷이 필요할 거예요=明天會下雨，所以他們需要帶上雨衣
땅에 눈이 많이 있었어요=地上積了很厚的雪
눈이 너무 많이 내려서 우리는 밖으로 나갈 수 없었어요=當時雪下得太大了我們出不去
주사위=骰子
던지다=扔；丟；擲
주사위는 이미 던져졌어요=骰子已經擲出去了
이것이 내가 생각하는 바입니다=我投了兩美分進去
벌다=賺取
아끼다=節省；保護
한 푼 아끼려고 하다 열 냥 잃는다=撿了芝麻，丟了西瓜；因小失大
세상사=世事；世故
세상사가 다 그런 거예요=那是不言而喻的；那是必然的
행동=行動；行為
~보다=比
말보다 행동이 중요해요=事實勝於雄辯
치료=治療；療程；療法
수술=手術
알약=藥丸；藥
환자=病人；患者
항생제=抗生素
크림=藥膏
술=酒精
패스트푸드=快餐
정크푸드=不健康的食品；垃圾食品
부서지다=打碎；破壞；摧毀
쉬다=休息
사용하다=使用
피하다=避免
효과=效果
효과가 있다=產生效果；有用
해롭다=有害的；不健康的
건강하다=健康的；身體好的
건강식=健康食品
즉시=立刻；馬上
최소한=至少
어떻게 해서 당신의 코가 부러졌어요?=你的鼻子怎麼斷的？
이 치료는 즉시 효과가 있어요=這種療法立竿見影
그 환자는 최소한 일주일은 쉬어야 해요=患者必須靜養至少一個禮拜
그 환자는 몸에 해로운 음식은 피해야 해요=患者應當避免垃圾食品
모든 패스트푸드가 정크푸드는 아니에요=不是所有的快餐都是垃圾食品
증거=證據
알리바이=不在場證明
훔치다=偷盜；偷
증명하다=證明
체포하다=逮捕；拘捕
풀어주다=釋放；放
사방에=到處；隨處
어디에도=無處；沒有任何地方
~없는=沒有
증거 없는 사건은 없어요=沒有證據無法立案
용의자는 알리바이가 없어요=嫌犯沒有不在場證明
목격자들이 사방에 있었어요=到處都有目擊證人
누군가가 마약을 훔쳤어요=有人偷把藥偷了
경찰은 증거 없는 용의자를 체포할 수 없어요=沒有證據警察不能逮捕嫌犯
그것은 아무것도 증명할 수 없어요=這不能證明任何事情
꿈=夢；夢想
꿈꾸다=做夢；幻想
팝스타=流行歌星
전문가=專家
음악가=音樂家
영화감독=導演
배우=男演員
여배우=女演員
디자이너=設計師
학위=學位；文憑
학위를 받다=拿一個學位
세계를 여행하다=環遊世界
열다=打開；開啟
닫다=關閉；關上
전문적인=專業的
가난하다=貧窮的
부자=有錢人；富人
내 평생=我這一輩子；我這一生
내 딸은 팝스타가 되고 싶어 해요=我女兒想當歌星
그는 세계를 여행하고 싶어 해요=他想去環遊世界
그의 가족은 가난하기 때문에 그는 부자가 되고 싶어 해요=他家很窮，所以他想當有錢人
나는 내 평생 유명한 작가가 되고 싶었어요=我這輩子就想成為一名著名作家
음악가가 되는 것은 내 꿈이에요=成為音樂家是我的夢想
나는 항상 전문적인 씨름 선수가 되는 것이 꿈이었어요=我一直夢想成為一名專業的韓國傳統摔角選手
커플=情侶；戀人
전 여자친구=前女友
전 남자친구=前男友
데이트 하다=約會 (動詞)
그리워하다=思念；想念
상관하다=在意
배려하다=關心；關懷
화해하다=和好；使 (雙方)和解
경멸하다=鄙視；瞧不起
서로=互相；彼此
그들은 더 이상 서로 말하지 않아요=他們再也不理對方了
우리는 커플이었지만 더 이상은 아니에요=他們以前是情侶，但現在不是了
그는 여전히 그의 전 여자친구를 배려해요=他還是很關心他的前女友
그들은 절대 서로 함께 말하지 않아요=他們從來不跟對方講話
우리는 화해해야 해요=我們應該和好
소란 피우다=小題大做
소란 피우지 마세요=別小題大做
정곡=靶；目標；靶心
찌르다=捅；刺；戳
정곡을 찔렀어요!=正中靶心！
입조심=守口如瓶
나는 입조심 했어야 해요=我得守口如瓶
정도=程度；水平
지나치다=過度的；過多的
당신은 정도가 지나쳤어요=你做得太過分了；你越界了
판단하다=評判；審判
당신이 판단하세요=由你來決定
마라톤=馬拉松
규칙=規則
노력=努力
메달=獎牌
금=金子
은=白銀
따다=摘取；採摘
메달을 따다=贏得獎牌
노력을 하다=做出努力；努力~
반칙하다=作弊；犯規
차다=踢
훈련하다=訓練
설명하다=解釋
거대하다=巨大的；龐大的
아주 작다=微小的；袖珍的
자랑스럽다=自豪的；驕傲的
만일 노력을 한다면, 너는 메달을 딸 수 있을 거야=只要你努力，就能贏得獎牌
만일 그녀가 금메달을 딴다면, 나는 그녀가 정말 자랑스러울 거예요=如果她贏得金牌，我會覺得非常自豪
압력=壓力
혈압=血壓
마취약=麻醉學
피부=皮膚
생리=月經；生理期
성별=性別
에너지=能量；能源
운동하다=運動；做運動 (動詞)
아파하다=感到痛苦
고통받다=(使) 痛苦；受折磨
우울하다=抑鬱的；鬱悶的
신선하다=新鮮的
꿈의 직업=理想的工作；夢寐以求的工作
나는 ~을 거예요=我會；我將 (虛擬語氣)
상상하다=想像 (動詞)
그것은 ~일 거예요=那將會~ (虛擬語氣)
독신=單身
실직하다=失業的；沒工作的
영원히=永遠
꿈의 직업을 상상하라=想像一下你夢寐以求的工作
상관없다=不關心；不在意；不介意
나는 돈은 상관없어요=我不在意錢
나는 영원히 싱글이고 싶지 않아요=我可不想單身一輩子
나는 당신이 정말 성공할 것이라고 확신해요=我敢肯定你一定會非常成功
나는 영원히 살고 싶어요=我想要長生不死
그것은 환상적일 거예요=那樣就太棒了！
이상형=(我的) 夢中情人 (男女皆可用)
얼간이=混蛋
사랑에 빠지다=墜入愛河；戀愛 (動詞)
헤어지다=分手；分開
공유하다=分享
망치다=毀掉；摧毀
상냥하다=可愛的；招人喜歡的
공손하다=有禮貌的
다정하다=溫柔的；溫和的；文質彬彬的
섹시하다=性感的
똑똑하다=高智商的；聰明的
웨딩=婚禮
결혼=婚姻
결혼하다=結婚 (動詞)
결혼했다=結婚了的
약혼하다=訂婚 (動詞)
약혼했다=訂婚了的；結婚了的
이혼하다=離婚 (動詞)
이혼했다=離婚了的
내 전부=我的一切；我的所有
내 반쪽=我的另一半
그녀는 내 이상형이기 때문에 ~=~因為她是我的夢中情人
당신의 이상형은 어떤 남자예요?=你的白馬王子是什麼樣的？
내 이상형은 용감하고 다정한 남자예요=我的白馬王子是一個勇敢又溫柔的人
그들은 삼 주 후에 약혼했어요=他們三週後就訂婚了
내 부모님은 이혼했어요=我父母離婚了
우리는 헤어졌어요=我們分手了
세상에 남자는 많아요=海裡的魚還多著呢（天涯和何處無芳草）
관점=觀點
대답=回答；回應 (名詞)
대답하다=回答；回應 (動詞)
사과하다=道歉；致歉 (動詞)
열심히=認真地
열심히 하다=努力；拼命
계속하다=繼續；持續 (做某事)
농담하다=開玩笑
반박하다=與~矛盾；抵觸
정직하다=誠實的
괜찮다=沒事的；沒關係的
같은=一樣的
당신은 노력해야 해요=你必須做出努力
같은 실수는 다신 하지 마세요=別犯同樣的錯誤
만일 당신이 열심히 한다면 모든 것이 다 괜찮을 거예요=只要你努力，一切都會好起來的
감옥=監獄
죄수=囚犯
판사=法官
감방=監牢；牢房；囚室
범죄 현장=犯罪現場
종신형=無期徒刑；終生監禁
법정=法庭
재판=審判
재판중에=庭審中
폭력=暴力
괴물=怪物；怪獸
맹세=發誓；起誓
맹세하다=賭咒；起誓
기억하다=記得；記住
선고하다=判決
~처럼 보여요=看起來像~；看上去似乎是~
~처럼 들려요=聽起來像~
믿다=相信
공격하다=攻擊；襲擊 (動詞)
방어하다=防禦；保護 (動詞)
평범하다=正常的；普通的
죄책감을 느끼다=有罪的；愧疚的
결백하다=無辜的；清白的
당신은 그가 어떻게 보였는지 기억해요?=你還記得他長什麼樣子嗎？
그는 괴물처럼 보였어요=他看起來像個怪物
나는 아무것도 모른다고 맹세해요!=我發誓我什麼都不知道！
나는 그를 믿지 않아요=我不相信他
판사는 강도에게 오년형을 선고했어요=法官判決那個搶劫犯五年的監禁
