훌륭하다=絕妙的；精彩的
아름답다=美麗的
예쁘다=漂亮的
강하다=強的；堅強的
약하다=弱的；軟弱的
뚱뚱하다=胖的
날씬하다=瘦的
못생기다=醜陋的
멋지다=酷的
크다=大的；高的
짧다=短的；矮的
작다=小的
길다=長的
생각=想法；思想
생각하다=想；思考；認為
~기에=引出後面句子的詞
그렇게=像那樣子；那麼
내가 생각하기에 ~=我認為~
그는 훌륭해요=他太棒了
그녀는 아름다워요=她很美
그것은 좋아요=這很好
정말 훌륭해요!=(那) 真是太棒了！
어떻게 생각해요?=你怎麼想？
내가 생각하기에 그것은 너무 길어요=我覺得這太長了
내가 생각하기에 그것은 너무 작아요=我覺得這太小了
나도 그렇게 생각해요=我也這麼想；懂你的意思
나는 그렇게 생각하지 않아요=我不這麼認為
언어=語言
한국어=韓語
한국어로=用韓語
말=單詞；馬
말하다=說；講；告訴；談論
~ 한국어로 어떻게 말해요?=~用韓語怎麼說？
이해하다=理解；(弄) 明白
~도=也；兩者之一
나도=我也~；我也不~
알다=知道 (某事)；了解~
모르다=不知道 (某事)；不了解~
나는 몰라요=我不知道
나도 몰라요=我也不知道
만나다=見面；會面
반갑다=開心的；樂意的
만나서 반가워요=很高興見到你
나도 만나서 반가워요=我也很高興見到你
되다=成為；變得
됐어요=成為了；已變得~
잘 됐어요!=太好了！
거기=那裡；那邊
여기=這裡；這邊
여기 있어요=給你；在這裡
천만에요=不用客氣；不用謝
행운=幸運；運氣
빌다=盼望；期望
행운을 빌어요!=祝你好運！
중국어=中文
나는 ~ㄹ 수 있어요=我能
조금=一點點
물론 ~=當然~
나는 중국어를 할 수 있어요=我說中文
당신은 한국어를 할 수 있어요?=你會說韓語嗎？
나는 한국어를 조금 할 수 있어요=我會說一點點韓語
물론 나는 중국어를 할 수 있어요=我當然會說中文
당신은 한국어를 정말 잘해요=你的韓語說得非常好
접시=碟子
유리잔=玻璃杯
컵=杯子
차 한잔=一杯茶
병=瓶子
스타터=前菜；開胃菜
메인 코스=主菜
디저트=甜點
저=我 (自謙語)
전혀=任何
뭔가=某事；某物
아무것도=任何事 (東西)；沒有事 (東西)
~으로 (~로)=表示方向的虛詞
~시겠어요?=~想要 (做~）嗎？ (禮貌用語)
차 드시겠어요?=您想要 (喝) 茶嗎？ (禮貌用語)
무엇으로 드시겠어요?=你想吃什麼？ (禮貌用語)
병으로 하시겠어요? 유리잔으로 하시겠어요?=您想要一整瓶還是一杯？
저는 차 한잔 좀 주시겠어요?=我可以點杯茶嗎？
저는 우유 좀 주시겠어요?=我可以點杯牛奶嗎？
디저트 좀 있어요?=你 (們) 有甜點嗎？
나는 아무것도 없어요=我什麼也沒有
나는 물이 전혀 없어요=我完全沒有水
물론 나는 물이 좀 있어요=我當然有水
십일=十一；11
십이=十二；12
십삼=十三；13
십사=十四；14
십오=十五；15
십육=十六；16
십칠=十七；17
십팔=十八；18
십구=十九；19
이십=二十；20
물건=東西；物品
시장=集市；市場
현금=現金
현금 입출금기=取款機
매점=雜貨舖
매장=商店
슈퍼마켓=超市
자동차=汽車；小轎車
택시=出租車
은행=銀行
서점=書店
작은 서점=小書店
약국=藥店；藥舖
큰 약국=大藥店；大藥房
목록=清單；目錄
쇼핑 목록=購物清單
고객=顧客
~들=加在名詞結尾表示複數
사람들=人；人們
새롭다=新的
오래되다=舊的
사다=買；購買
팔다=賣；銷售
돈=錢；金錢
돈을 내다=支付；付款
가다=去；走
쇼핑 가다=去買東西
원하다=想要 (某物)
~고 싶다=想要 (做某事)
사고 싶어요=想要買
쇼핑 가고 싶어요=想去買東西
많이=很多
약간의=若干；稍微；一點
~에=表示地點的虛詞
시장에=往集市
~에 갑시다=我們去 (地點) 吧！
시장에 갑시다=我們去集市吧
나는 새 차를 원해요=我想要輛新車
나는 당신을 위해 뭔가를 좀 사고 싶어요=我想買點東西給你
큰 약국이 있어요=那邊有家大藥房
사람들이 많이 있어요=那里人很多
현금 입출금기가 있어요?=(這兒) 有取款機嗎？
은행이 없어요=(這兒) 沒有銀行
작은 서점들이 많이 있어요=(這兒) 有很多小書店
가장 좋아하는=最喜歡的
내가 가장 좋아하는=我最喜歡的
음료=飲料
이것=這個；這一個
저것=那個；哪一個
사실=實際上；其實；真相
~이나 (~나)=或者
그는 커피를 좋아해요=他喜歡喝咖啡
그는 생선을 좋아하지 않아요=他不喜歡吃魚
그녀는 차나 커피를 좋아하지 않아요=她不喜歡茶和咖啡
음식이 없어요=沒有吃的了
수프 좀 있어요?=有湯嗎？
커피는 내가 가장 좋아하는 음료예요=咖啡是我最喜歡的飲料
사실 나는 그것을 좋아해요=其實我喜歡 (它；這個)
이것은 맛있어요=這個很好吃
그것은 뭐예요?=那是什麼？
물론 그는 샐러드를 좋아해요=他當然喜歡沙拉
가족=家人；家庭
엄마=媽媽
아빠=爸爸
부모님=父母 (父親或母親)
누나=姐姐 (男性用語)
언니=姐姐 (女性用語)
여동생=妹妹
형=哥哥 (男性用語)
오빠=哥哥 (女性用語)
남동생=弟弟
할아버지=爺爺；外公
할머니=奶奶；外婆
조부모님=祖父母 (祖父或祖母)
아들=兒子
딸=女兒
친구=朋友
남자친구=男朋友
여자친구=女朋友
남편=丈夫
부인=妻子
여자=女人
남자=男人
소년=男孩子
소녀=女孩子
아이=小孩子；兒童
아기=嬰兒
성인=成年人
직업=工作；職業
학교=學校
사무실=辦公室
~에서=從~；在~裡；在；在~上
사무실에서=在辦公室裡
일하다=工作 (動詞)
누구 (누가)=誰
제=我的 (自謙語)
제 엄마=我的媽媽
이분=這個人 (禮貌用語)
이분은 제 엄마예요=這是我媽媽
이분은 제 엄마와 아빠예요=這是我的媽媽爸爸
그들은 누구예요=他們是誰？
그는 내 형이에요=他是我哥哥 (男性用語)
그는 여자친구가 있어요?=他有女朋友嗎？
당신의 남자친구는 직업이 있어요?=你男朋友有工作嗎？
그는 사무실에서 일해요=他在辦公室工作
색=顏色；色彩
빨간색=紅色
파란색=藍色
노란색=黃色
초록색=綠色
검은색=黑色
분홍색=粉紅色；粉色
보라색=紫色
하얀색=白色
주황색=桔紅色；桔黃色
갈색=棕色
회색=灰色
연한=淺的；淺色的
짙은=暗的；深色的
연한 파란색=淺藍色
짙은 빨간색=深紅色
실례합니다=(不好意思) 打擾一下
병원=醫院
병원은 어디에 있어요?=醫院在哪裡？
아주 조금=只是一點點
충분하다=足夠的；充分的
그것이면 충분해요!=夠了！
뭐 해요?=你在做什麼？
가능=可能性
불가능=不可能性；不可能的事
가능하다=可以~；可能~
불가능하다=不可以~；不可能~
그것은 가능해요=這是可能的；有可能
그것은 가능해요?=這可能嗎？
그것은 불가능해요!=這不可能！
물론이지!=當然！
유감=遺憾；可惜
정말 유감이에요!=太令人遺憾了！
옷=衣服
바지=(一條) 褲子
셔츠=襯衫
티셔츠=T恤衫
치마=短裙
드레스=連衣裙
반바지=短褲
코트=大衣；庭院
재킷=夾克外套
점퍼=套頭衫
스카프=圍巾
모자=帽子
양복=西裝
양말=襪子
신발=鞋
운동화=運動鞋；球鞋
부츠=靴子
슬리퍼=拖鞋
장갑=手套
팬티=內褲
우산=雨傘；傘
지갑=錢包
가방=包；袋子
닫혔어요=關閉的；關著的
열렸어요=打開；打開的
오줌을 싸다=小便 (動詞)；撒尿
나는 ~야 하다=我應該；我必須；我不得不~
나는 우산을 사야 해요=我得買把傘
나는 옷을 좀 사야 해요=我得買幾件衣服
그는 파란색 바지를 원해요=他想要一條藍色的褲子
나는 오줌을 싸야 해요=我得解小便
은행은 열렸어요=銀行是開著的
견과류=堅果
사탕=糖果
초콜릿=巧克力
케이크=蛋糕
피자=匹薩
팝콘=爆米花
설탕=糖
소금=鹽
후추=胡椒
알레르기=過敏
~에 알레르기가 있어요=對~過敏
중독=上癮
~에 중독됐어요=對~上癮
뜨겁다=燙的；熱的
맵다=辛辣的
식다=冷的；涼的（食物）
채식주의자=素食主義者；素食者
~용=適合~；對~是合適的
채식주의자용=(適合) 素食者
초콜릿을 좋아해요?=你喜歡吃巧克力嗎？
그것은 정말 좋아요=這是非常好的
수프가 뜨거워요?=湯是燙的嗎？
나는 채식주의자예요=我是素食主義者
이것은 채식주의자용이에요?=這個素食者能吃嗎？
그는 견과류에 알레르기가 있어요=他對堅果過敏
우리는 설탕에 중독됐어요=我們對糖上癮
인간=人類
동물=動物
개=狗；(一) 片
고양이=貓
새=鳥
물고기=魚
소=牛
돼지=豬
닭=雞
토끼=兔子
뱀=蛇
사자=獅子
코끼리=大象
양=綿羊；數量
원숭이=猴子
강아지=小狗
새끼 고양이=小貓
기린=長頸鹿
당나귀=驢
생쥐=老鼠
충성스럽다=忠誠的
용감하다=勇敢的
영리하다=聰明的
멍청하다=愚蠢的
고집스럽다=固執的
자유롭다=自由的
조용하다=安靜的
시끄럽다=大聲的；喧嘩的
귀엽다=可愛的
~처럼=像；像~一樣
개처럼 충성스러운=像狗一樣忠誠
새처럼 자유로운=像鳥兒一樣自由
하나=一；1 (韓音數字)
둘=二；2 (韓音數字)
셋=三；3 (韓音數字)
넷=四；4 (韓音數字)
다섯=五；5 (韓音數字)
여섯=六；6 (韓音數字)
일곱=七；7 (韓音數字)
여덟=八；8 (韓音數字)
아홉=九；9 (韓音數字)
열=十；10 (韓音數字)
열하나=十一；11 (韓音數字)
열둘=十二；12 (韓音數字)
하루=一天 (24小時)
주=星期；週
월=月
년=年
살=歲數；年紀；肉
나이가 많은=老的；上年紀的
어리다=年輕的
몇=多少
몇 살=多大年紀；幾歲
이것은 내 개예요=這是我的狗
그는 몇 살이에요?=他幾歲了？
그는 열두 살이에요=他十二歲了
내 고양이는 정말 나이가 많아요=我的貓已經很老了
당신은 정말 어려요=你很年輕
깃발=旗子
타운=鎮；小城
도시=城市
수도=首都
아파트=公寓
집=房屋；住宅
베이징=北京
상하이=上海
서울=首爾
부산=釜山
살다=生活；居住
너무=太；如此
항상=總是
절대=從不；絕不
왜=為什麼
~기 때문에=因為
그들은 부산에 살아요=他們住在釜山
그녀는 서울에 집이 있어요=她在首爾有套房子
당신은 항상 행복해요=你總是很快樂
그는 절대 행복하지 않아요=他從來都不快樂
당신은 왜 그렇게 슬퍼해요?=你為什麼這麼難過？
당신이 아프기 때문에 ~=~因為你生病了
배고프기 때문에 ~=~因為我餓了
나는 배고프기 때문에 화가 나요=我生氣是因為肚子餓了
그는 여자친구가 없기 때문에 조금 슬퍼해요=他有點難過是因為沒有女朋友
삼십=三十；30 (漢音數字)
사십=四十；40 (漢音數字)
오십=五十；50 (漢音數字)
육십=六十；60 (漢音數字)
칠십=七十；70 (漢音數字)
팔십=八十；80 (漢音數字)
구십=九十；90 (漢音數字)
백=一百；100 (漢音數字)
이십육=二十六；26 (漢音數字)
사십육=四十六；46 (漢音數字)
삼백=三百；300 (漢音數字)
시간=時間
시=小時
분=分鐘
초=秒
전=之前
후=之後
약속=約會；約定
데이트=約會 (情侶間的)
미팅=會議；會見
언제=什麼時候
지금=現在
거의=幾乎
정각=~點鐘
몇 시예요?=現在幾點？
두시 정각이에요=現在兩點鐘
여덟시 삼십분이에요=現在八點半
십분 전 두시예요=現在差十分鐘兩點
다섯시 육분이에요=現在是五點過六分
몇 시에?=在什麼時間？
십분 전 네시에=在差十分鐘四點的時候
당신의 데이트는 언제예요?=你的約會是什麼時候？
한시 정각에=在一點鐘的時候
