고기=肉
소고기=牛肉
돼지고기=猪肉
닭고기=鸡肉
계란=鸡蛋
삼겹살=三层肉、五花肉
갈비=烧肉
등심=里肌肉
생선=鱼
참치=鲔鱼(tuna)
넙치=比目鱼(flounder)
농어=鲈鱼(striped bass)
도미=鲷鱼(snapper)
새우=虾子
복어=河豚(puffer fish)
문어=章鱼(octopus)
오징어=鱿鱼(squid)
꽃게=螃蟹
조개=贝类(shellfish)
굴=牡蛎(oyster)
전복=鲍鱼
성게=海胆(sea urchin)
야채=蔬菜
고추=辣椒
풋고추=青辣椒
부추=韭菜(chive)
마늘=大蒜
파=葱
양파=洋葱
콩=大豆
콩나물=大豆芽
고사리=蕨类(fern)
배추=白菜(chinese cabbage)
당근=红萝卜
무(우)=白萝卜
버섯=香菇
시금치=菠菜
상추=生菜(牛奶莴苣 lettuce)
오이=小黄瓜
양배추=高丽菜(cabbage)
감자=马铃薯
가지=茄子
토마토=番茄
고구마=地瓜(sweet potato)
참깨=胡麻/芝麻(sesame)
옥수수=玉米
임삼=高丽人参
생강=(生)姜
과일=水果
사과=苹果
배=梨子
감=柿子(persimmon)
포도=葡萄
복숭아=桃子(peach)
귤=橘子(mandarin orange)
오렌지=柳橙(orange)
레몬=柠檬(lemon)
바나나=香蕉(banana)
파인애플=凤梨(pineapple)
수박=西瓜
참외=香瓜(melon)
멜론=哈密瓜(cataloupe)
딸기=草莓
앵두=樱桃(cherry)
밤=栗子(chestnut)
호두=胡桃(walnut)
잣=松子(pine nut)
땅콩=花生
