어지럽다=to be dizzy
두통이 심하다=to have a severe headache
편두통이 심하다=to have a severe migraine
뻐근하다=to feel stiff
목이 뻐근하다=to have a stiff neck
어깨가 결리다=to feel tight in one's shoulders
시큰거리다=to have a sharp pain
손목이 시큰거리다=to have a sharp pain in one's writst
무겁다=to feel heavy
몸이 무겁다=to feel one's body heavy, feel tired
허리를 펴다=to straighten one's back
머리를 숙이다=to lower one's head
고개를 젖히다=to bend back one's head
목을 돌리다=to roll one's neck
팔을 뻗다=to stretch out one's arm
팔을 올리다=to raise one's arm
무릎을 당기다=to pull one's knee
다리를 벌리다=to spread one's legs
무릎을 굽히다=to bend one's knee
귀찮다=to be bothersome
지키다=to keep (a promise)
실천하다=to carry out
보양식=health food (예: 삼계탕, 추어탕)
챙겨 먹다=to eat without skpping meals
유지하다=to maintain
반복하다=to repeat
조카=nephew, niece
돌보다=to look after
재충전=recharge
원하다=to want
답하다=to answer
습관=habit
야근=overtime work at night
평일=weekday
최근=recently
