기쁨=joy
슬픔=sorrow
신이 나다=to be excited
뿌듯하다=to be satisfied, great feeling on doing something well
자랑스럽다=to be proud
안타깝다=to be a pity
속상하다=to be upset
가슴이 아프다=to be heartbreaking (마음이 아프다)
긴장이 되다=to be nervous
섭섭하다=to be disappointed
짜증이 나다=to be annoyed
편찮다=to be sick (honorific)
돌아가시다=to pass away
이별하다=to part, farewell
남자 친구와 헤어지다=to brea up (with one's boyfriend)
여자 친구한테 차이다=to get dumped (by one's girlfriend)
사고를 당하다=to be involved in an accident (to have an accident)
상을 당하다=to be bereaved
망신을 당하다=to be humiliated
다 잘될 거예요=Everything will turn out all right.
기운 내세요=Cheer up.
안다=to hug
어깨를 토닥이다=to pat one's shoulder
손을 잡다=to hold hands
위로하다=to console
청첩장=wedding invitation
신경을 쓰다=to take care, concern, pay attention
입원하다=to be hospitalized
치료를 받다=to get treated
간호하다=to nurse
참석하다=to attend
한턱내다=to treat somebody to(with) food, drink
첫날=the first day
찾아오다=to visit, come to see
위로=consolation
생각이 들다=to come to mind, something get into my head
잠시=for a while
눈물을 흘리다=to shed tears
배=times (counting unit for multiples) 두 배, 세 배, 네 배
소중하다=to be precious
