교복=school uniform
체육복=gym clothes (clothes for a PE class)
소풍=picnic
수학여행=school field trip
도시락=lunchbox
매점=snack bar, kiosk for snack
선배=one's senior
후배=one's junior
짝=partner
담임 선생님=homeroom teacher
그립다=to miss (somebody), want to see
아쉽다=to be a shame
정이 들다=to become attached to (grow fond of)
인상적이다=to be impressive
기억에 남다=to be memorable
후회(가) 되다=to come to regret
기억(이) 나다=to remember
동창=alumnus: schoolmate
동창회=alumni meeting
수학=mathematics
교내=in the school building
신문사=newspaper company
활동하다=to act, work in
부럽다=to envy
사실=actually
국어=a national language
작별=farewell
너희=you guys (반말: talking down/between close friends)
늘=always
드디어=finally, at last
