날씨=weather
기후=climate
비가 내리다=to rain
눈이 내리다=to snow
비가 그치다=to stop snowing
안개가 끼다=to be foggy
구름이 끼다=to be cloudy
안개가 걷히다=(fog) to clear
구름이 걷히다=(cloud) to clear
건조하다=to be dry
습하다=to be humid
장마가 시작되다=(monsoon) to come to begin
기온이 영하로 내려가다=(temperature) to fall below zero
무더위=heat wave
강추위=bitter cold
폭우=heavy rain
폭설=heavy snow
황사가 심하다=(yellow-dust) to be severe
일교차가 크다=to have a large temperature difference
홍수가 나다=to have a flood
가뭄이 들다=to have a drought
태풍이 오다=have a typhoon come in
우박이 쏟아지다=to hail heavily
엄청=very much, spoken style (아주, 많이)
날씨가 풀리다=(weather) to get warmer
복날=hottest days of the year
초=beginning
월초=beginning of a month
월중=middle of a month
월말=end of a month
물에 잠기다=to sink (under water)
큰아들=eldest son
작은아들=younger son
장수=vendor, seller, peddler
부채=hand fan
한숨을 쉬다=to sigh
어떤=certain
벌다=to earn (money, time)
이후=after (this)
