신고=report, declaration
신청=application
분실 신고=lost item report
고장 신고=damage item report
도난 신고=theft report
출생 신고=birth registration
혼인 신고=marriage registration
사망 신고=death report
범죄 신고=crime report
화재 신고=fire report
실종 신고=missing person report
수강 신청=class registration
수리 신청=repair application
신용 카드 신청=credit card application
여권 발급 신청=passport application
작성하다=to fill out (신청서를 ~)
서명하다=to sign
도장을 찍다=to stamp
첨부하다=to attach (사진을~)
접수증을 받다=to get a filing receipt
고객=customer
전원=power (of electronic devices)
외=expect
액정=Liquid Crystal Display (LCD)
깨지다=to be broken
바닥=floor
떨어뜨리다=to drop
AS 센터=Customer Service Center
휴무이다=to be closed (of a shop), to be a day off
위치=location
신분증=identification card
외국인등록증=alien registration card
재발급=re-issuance
수수료=service fee
진열되다=to be displayed
계산대=checkout counter
금고=a safe
도둑이 들다=to have a burglar break in (집에~)
재단=foundation
이수=completion
학점=credit; grade
평점=Grade Point Average (GPA)
재학생=enrolled student
성적증명서=official transcript
통장=bank account
발표=announcement
부=copy (unit noun)
유의 사항=matters requiring attention
우편 접수=mail-in application
영문=written in English
생년월일=date of birth
체류=stay, sojourn
본인=oneself
인=stamp, signature (in a official document)
에 대해 문의하다=to make an inquiry about
제출하다=to submit (서류를(document)~)
