클렌징=cleansing cream
폼클렌징=foam
팩=facial mask
스킨=lotions,toner
로션=emulsions
펄파우더=pearl powder
파우더 포푸=facial buffer
파우더 블러셔=blusher
크림=cream
수분크림=moisturizer
에센스=essence
썬크림=sunscreen
메이크업베이스=segregation frost
파운데이션=foundation
비비크림=BB Cream
영양크림=nourishing cream
마사지크림=Massage cream
모이스처라이저=moisturizer
끈적이지 않는 핸드크림=non-greasy hand cream
가루루스파우더=loose powder
압축파우더=pressed powder
트윈케익=wet and dry powder
컨실러=concealer
마스카라=mascara
속눈썹뷰러=eyelash curler
속눈썹을 말아 올리다=rolled eyelashes
아이브로우 펜슬=eyebrow pencil
아이섀도우=eye shadow
아이펜슬=eyeliner
립스틱=lipstick
립글로즈=lip gloss
립밤=lip balm
립틴트=light lip gloss
건성피부=dry skin
중성피부=mild skin
지성피부=oily skin
복합성피부=composite skin
여드름피부=acne skin
지성피부에 맞다=for oily skin
매끄러운 피부결=smooth skin
보드라운 살결=soft skin
피부유연=supple skin
뽀송한 피부=supple skin
스킨케어=skin care
다크서클=black eye
미백화장품=whitening cosmetics
기능성화장품=functional cosmetics
주근깨화장품=freckles cosmetics
기미화장품=mole removal cosmetics
멜라닌 제거=remove melanin
블랙헤드제거=Remove blackheads
고보습=high moisture
피부가 축축하다=skin moisturizer
청정보습효과=Cleansing moisturizing effect
피지제거=removing sebum
모공축소전용=compact pores dedicated
안티 블레미쉬=anti-blemish
각질정리=exfoliates
피부에 기름기가 많다=oily skin
유분기를 확실히 잡아주다=give out the oily
노폐물 제거=clear metabolism
모공속 블랙헤드=pores blackheads
화이트헤드=whellote-head
좌창=acne
거뭇거뭇 블랙헤드=black nose
모공엔센스=pores essence
모공의 청정작용=pore ​​cleansing effect
얼굴에 마사지하듯 문질러 주다=like face massage
손눌림 후에 알갱이 생기다=produce small particles after hand massage
얼굴 전체에 가볍게 펴 바르다在=sticks on gently in the entire face
딥 클렌징 제품=deep-cleansing product
스크럽 제품=granular cleanser
피부에 무리가 가다=burden on the skin
천연 셀룰로오즈를 이용하다=use of natural cellulose
윤기부여=moisturizing effect
펄함유=pearl containing
유수분밸런스조절=oil moisture balance
오일컨트롤=oil control
주름개선=antiwrinkle
퓨어 내추럴 허브=natural herbs
유분이 묻아나다=conceal oil
넓은 모공 포어필링젤=pore peeling gel
피부결정돈=moisturize the skin texture
선탠 로션=sunscreen lotion
대낮에 땡밭에 서다=exposure to sunlight
커버력=covering effect, concealer
여드름=blackhead
생기부여=grant animation
보란색을 약간 띄는 하늘색=slightly with light blue
노화방지=anti-aging
노메크업=without makeup
자신있는 쌩얼=Confident without makeup
자외선이중차단=dual uv protection
번짐방지=prevent blooming
지속력 높이다=long-lastingr
저자극=hypoallergenic
라이트 베이지=light deige
샌드베이지=dark beige
뾰족용기=high bottle container
진공용기=vacuum vessel
밀리리터=milliliter
샘플제품=sample
서비스=free gift
한국산 제품=Korean products
글로벌 셀러=global direct selling
가격대비가 가장 무난한 듯하다=the most affordable
