클렌징=卸妆膏
폼클렌징=洗面奶
팩=面膜
스킨=爽肤水
로션=乳液
펄파우더=珍珠粉
파우더 포푸=面扑
파우더 블러셔=腮红
크림=霜
수분크림=保湿霜,补水润肤霜
에센스=精华露,精华霜
썬크림=防晒霜 
메이크업베이스=隔离霜
파운데이션=粉底霜 
비비크림=BB霜
영양크림=营养霜,(防皱,美白)
마사지크림=按摩霜
모이스처라이저=润肤霜
끈적이지 않는 핸드크림=不粘稠的护手霜
가루루스파우더=散粉
압축파우더=粉饼
트윈케익=干湿两用粉饼
컨실러=修容膏
마스카라=睫毛膏
속눈썹뷰러=睫毛夹
속눈썹을 말아 올리다=卷起睫毛
아이브로우 펜슬=眉笔
아이섀도우=眼影
아이펜슬=眼线笔 
립스틱=口红,唇膏
립글로즈=唇彩
립밤=润唇膏
립틴트=淡色唇彩
건성피부=干性皮肤
중성피부=中性皮肤
지성피부=油性皮肤
복합성피부=复合性皮肤
여드름피부=痘痘皮肤
지성피부에 맞다=适用于油性皮肤
매끄러운 피부결=光滑的皮肤
보드라운 살결=柔软的皮肤
피부유연=柔嫩皮肤
뽀송한 피부=柔嫩肌肤
스킨케어=皮肤护理
다크서클=黑眼圈
미백화장품=美白化妆品
기능성화장품=机能性化妆品
주근깨화장품=祛斑化妆品
기미화장품=消痣化妆品
멜라닌 제거=去除黑色素
블랙헤드제거=除黑头
고보습=高保湿
피부가 축축하다=皮肤保湿的
청정보습효과=净颜保湿效果
피지제거=去皮脂
모공축소전용=紧致毛孔专用
안티 블레미쉬=净颜去污
각질정리=清理角质
피부에 기름기가 많다=皮肤油性大
유분기를 확실히 잡아주다=完全清除油份
노폐물 제거=清除新陈代谢物
모공속 블랙헤드=毛孔内黑头
화이트헤드=白头
좌창=痤疮
거뭇거뭇 블랙헤드=黑黑的黑鼻头
모공엔센스=毛孔精华素
모공의 청정작용=毛孔清洁作用
얼굴에 마사지하듯 문질러 주다=好像按摩似的在脸上揉搓
손눌림 후에 알갱이 생기다=用手按摩后产生小颗粒
얼굴 전체에 가볍게 펴 바르다在=整个脸部轻轻敷开
딥 클렌징 제품=深层净颜产品
스크럽 제품=磨砂式去角质
피부에 무리가 가다=对皮肤造成负担
천연 셀룰로오즈를 이용하다=利用天然纤维素
윤기부여=增添润泽效果
펄함유=含有珍珠成分
유수분밸런스조절=平衡油份水分
오일컨트롤=控油
주름개선=改善皱纹
퓨어 내추럴 허브=纯天然草本植物
유분이 묻아나다=掩盖住油份
넓은 모공 포어필링젤=毛孔粗大角质凝胶
피부결정돈=润泽皮肤纹理
선탠 로션=防晒乳液
대낮에 땡밭에 서다=在烈日下暴晒
커버력=遮瑕效果
여드름=黑头粉刺
생기부여=增添生气
보란색을 약간 띄는 하늘색=略显着的淡蓝色
노화방지=防止老化
노메크업=素颜
자신있는 쌩얼=有自信的素颜
자외선이중차단=双重防护紫外线
번짐방지=防止晕染
지속력 높이다=提高持久力
저자극=防过敏
라이트 베이지=浅米色
샌드베이지=深米色
뾰족용기=高瓶容器
진공용기=真空容器
밀리리터=毫升
샘플제품=试用装
서비스=赠品 
한국산 제품=韩国产品
글로벌 셀러=国外直销
가격대비가 가장 무난한 듯하다=看起来也最实惠
