가르쳐 주십시오=請告訴我
가르침을 부탁드립니다!=謝謝您的教導!
거실로 들어와 앉으십시오=請在客廳坐
걱정하지 마시기 바랍니다=請不要擔心
계산대로 와서 처리해주세요계산대=請到櫃檯辦理
공사장이니 들어오지 마시오=施工重地，請勿入內
과자 좀 드시지요=請吃點心甜食
교실에서는 실내화를 신으세요=在教室裡請穿拖鞋
귀중품은 휴대하시기 바랍니다=請攜帶您的貴重物品
귀찮으시겠지만 이 편지를 그에게 좀 전해 주십시오=煩請將這封信交給他
귀하께 한 가지 부탁드립니다=我要求您一件事
그녀의 요구를 허하다=答應她的請求
그는 초청되어 갔다=他被人請去了
그렇게 많은 손님을 청할 수 없다=請不起這麼多客人
그렇게 빨리 말하지 마세요=請別說得那麼快
그를 오라고 청하다=懇請他來
그에게 와달라고 부르다=請約他來
꽃가지를 꺾지 마시오=請勿摧折花枝
나는 그녀를 집으로 초대하려고 한다=我要邀請她到家裡
나오지 마십시오. 그만 들어 가십시오=別送別送，請留步
내가 그를 오라고 특별히 청한 것이다=是我專門請他來
내게 접근하지 마라접근=請你不要靠近我
네가 한턱내라=你請我吧
다 읽고 나면 제자리에 되돌려 주십시오!=看完請放回原處!
다시 한 번 말씀해 주시오=請再說一遍
담배를 피우지 마시오=請勿吸煙
뒤로 한 발 물러가 주십시오물러가다=請您後退一步
뒷면을 보시오뒷면=請閱背面背面
떠들지 마시오=請勿喧嘩
많은 도움을 바랍니다=請你多多幫助
많이 가르쳐 주십시오=請您多多指教
많이 돌보아 주시기 바랍니다=請多多關照
많이 찾아 주십시오=請您多多照顧
말씀 낮춰 하십시오=請放低聲音說話
머리 좀 돌려 보세요=請你回過頭來
먼저 시작하십시오=請你先起個頭
먼저 앉으십시오=您先請坐
명확한 대답을 주십시오=請給一個明確的答覆
모두에게 안부 전해 주시기 바랍니다=請向大家問好
문의 좀 하겠습니다=請打聽一下
방안에 들어와 앉으십시오=請屋裡坐
배상금을 청구하다=請求賠償費
병 때문에 하루의 휴가를 신청하다=因病請假一天
병 때문에 휴가를 얻다=因病請假
부디 잘 부탁합니다=請多多關照
빠른 시일 내에 대답해 주십시오=請盡快答覆
상세히 설명해 주십시오=請詳細解釋
성함이 어떻게 되세요?=你叫什麼名字?
손대지 마시오손대다=請勿觸摸
식사하러 가자, 내가 한턱내지=我请我們去吃飯吧，我請你
실례지만 성함이 어떻게 되세요?=對不起，請問您貴姓?
아무 데나 가래를 뱉지 마시오=請勿隨地吐痰
안쪽에 앉으십시오=請裡頭坐
안쪽으로 들어와 앉으십시오=請裡面坐
앉으십시오=您請坐
양해해 주실 것을 간청합니다=懇請諒解
양해해 주십시오!=請您原諒!
어서 드십시오!=請動筷子吧!
어서 들어오세요=請進
여기서 잠시 기다리시오=請在此稍等片刻
영주권을 신청하다=申請永久居留權
오늘은 내가 한턱내지=今天我请客
온 집이 평안하니 걱정마십시오=全家安康，請不必掛心
요리를 좀 많이 드십시오!=請多吃一點菜!
요지를 좀 말씀해 주십시오=請你把大意說一下
용서를 구하다=請求寬恕
의사에게 왕진을 청하다=請醫生來看病
의사에게 진료를 받았나요?=請醫生看了沒有?
이 구절이 무슨 뜻인지 좀 가르쳐 주십시오=請告訴我這句話的意思?
이 글자를 도려 주십시오!=請把這個字刪去!
이 답안을 새겨 주세요=請記住這個答案
이번에 나는 30여명의 사람을 초대했다=這一次，我邀請了30多人
이쪽으로 내려앉으시오=請坐過來
이쪽으로 오십시오=請你來這裡
이후에는 어떻게 할까요?=我們該怎麼辦呢?
입학신청서=入學申請表
자리에 앉아 주십시오=請入座
잔치에 친구를 초대하다=盛宴邀請朋友
잘못된 점이 있으면 많이 지적해 주십시오=不對的地方，請您多指教
잠깐 가다려 주세요=請稍等
잠깐 기다려 주세요=請稍等片刻
잠깐 기다려 주세요=請稍等一會兒
저 좀 도와주세요, 예?=請幫我的忙，好嗎？
저를 대신해서 그에게 안부를 전해 주십시오=請代我向他問好
저에게 5분을 주십시오=請給我五分鐘
전화로 좀 알려주시오=請來電話告知
절대로 우왕좌왕하지 마세요=請你切莫驚慌失措
제 곁으로 오세요=請你走到我身邊
제 호의를 마다하지 마십시오=請你不要拒絕我的好意
제가 그린 그림을 보십시오=請看我畫的畫
좀 크게 말씀해 주세요=請你說大聲點
주–여, 저를 보살펴주소서=天主啊，請照顧我
진지 드십시오=請吃飯吧
차를 마시세요=請喝茶
차에서 내릴 준비를 하세요=請您準備下車
책을 펼치십시오=請翻開書本
처음 뵙겠습니다.잘 부탁드립니다=初次見面，請多關照
초청장=邀請
편지를 그에게 전하여 주십시오=請把信轉給他
하루바삐 병이 회복되길 바란다=願你早日康復
행인은 인도를 이용해 주십시오=行人請走人道
