가다=to go
가르치다=to teach
가지다=to have
갖다=to have
거짓말하다=to lie
걱정하다=to worry
걷다=to walk
걸다=to call, dial
결혼하다=to marry
고백하다=to confess
공부하다=to study
굽다=to roast, grill, bake
기다리다=to wait
기억하다=to remember
꿈꾸다=to dream
끓이다=to boil
끝나다=to finish
나가다=to exit
내다=to pay
닫다=to close
대답하다=to answer
도와주다=to help
도착하다=to arrive
듣다= to hear
들어오다=to enter
마시다=to drink
만나다=to meet
만들다=to make
말하다=to talk, speak
먹다=to eat
모르다=to not know
묻다=to ask
물어보다=to ask
배우다=to learn
벗다=to undress, take off clothes
보내다=to send
보다=to see
볶다=to fry
빌리다=to borrow, lend
사다=to buy
사랑에 빠지다=to fall in love
사랑하다=to love
사용하다=to use
살다=to live
생각하다=to think
서두르다=to hurry, rush
섞다=to mix, blend
소개하다=to introduce
쉬다=to rest
시작하다=to start
신다= to wear (shoes, socks, footwear)
싫어하다=to hate, dislike
싸우다=to fight
썰다= to chop, slice
쓰다=to write
쓰다=to wear (hat, eyewear)
씻다=to wash
앉다=to sit
알다=to know
약속하다=to promise
없다=to not have
연습하다=to practice
열다=to open
오다=to come
요리하다=to cook
운동하다=to exercise
운전하다=to drive
울다=to cry
웃다=to laugh
이기다=to win, defeat
이야기하다= to talk, chat
일어나다=to get up
일하다=to work
읽다=to read
입다=to wear
있다=to have
자다=to sleep
재다=to measure, weigh
전화하다=to telephone
좋아하다=to like
죄송하다=to be sorry
주다= to give
주문하다=to order
죽다=to die
준비하다=to prepare
지다=to lose, be defeated
찌다=to steam
찍다=to take (picture)
찾다=to find,to look for
청소하다=to clean
축하하다=to congratulate
출발하다=to depart
춤추다=to dance
타다=to ride
태어나다=to be born
튀기다=to deep fry
팔다=to sell
필요하다=to need
하다=to do
휘젓다=to stir
