괜찮다=alright, ok
화나다=angry
짜증나다=annoyed
나쁘다=bad
아름답다=beautiful
크다=big
쓰다=bitter
심심하다=bored
지루하다=boring, dull
씩씩하다=brave
싸다=cheap
싸늘하다=chilly, frosty
통통하다=chubby
깨끗하다=clean
흐리다=cloudy
춥다=cold (regarding weather)
차갑다=cold, icy, chilly (regarding touch, objects)
편하다=comfortable
편리하다=convenient
시원하다=cool, refreshing
귀엽다=cute
축축하다=damp, clammy, wet
습하다=damp, moist, humid
맛있다=delicious, tasty
다르다=different
어렵다=difficult
더럽다=dirty
건조하다=dry
건조하다=dry, arid
이르다=early
쉽다=easy
당황하다=embarrassed
비어 있다=empty
비싸다=expensive
빠르다=fast
뚱뚱하다=fat, overweight
기름지다=fatty, greasy, oily
적다=few, little
신선하다=fresh
가득하다=full, crammed
젖다=get wet, damp
기쁘다=glad, happy
잘생기다=good looking
착하다=good-natured, nice
좋다=good, fine
행복하다=happy
딱딱하다=hard, stiff
건강하다=healthy
높다=high
뜨겁다=hot (touch, objects)
덥다=hot (weather)
배가 고프다=hungry
불편하다=inconvenient
재미있다=interesting
복잡하다=jammed, crowded
늦다=late
적다=less
많다=lots, many
시끄럽다=loud, noisy
비열하다=mean, nasty
촉촉하다=moist
좁다=narrow
새롭다=new, fresh
재미없다=not interesting, boring
맛없다=not tasty
오래되다=old (regarding objects)
예쁘다=pretty
조용하다=quiet
슬프다=sad
짜다=salty
무섭다=scary
날카롭다=sharp, pointed
뾰족하다=sharp, pointed
수줍다=shy
아프다=sick, painful
비슷하다=similar
깡마르다=skinny, scrawny
졸리다=sleepy
날씬하다=slim, slender
미끄럽다=slippery
느리다=slow
작다=small
똑똑하다=smart, clever
부드럽다=soft
말랑하다=soft, tender, ripe
시다=sour
시큼하다=sour
맵다=spicy
강하다=strong
튼튼하다=sturdy
멍청하다=stupid, foolish
놀라다=surprised
달다=sweet
달콤하다=sweet
같다=same
목이 마르다=thirsty
피곤하다=tired, exhausted
못생기다=ugly
불편하다=uncomfortable
급하다=urgent
따뜻하다=warm
약하다=weak, feeble
이상하다=weird, strange
넓다=wide, broad
