PC방=n.音{PC房} 網咖
가게=n.店鋪
가격=n.價格
가구=n.傢俱
가난=n.貧窮
가내=n.家中
가능=n.可能
가능성=n.可能性
가로=n.橫著,橫向
가로등=n.路燈
가로수=n.林蔭樹,行道樹
가루=n.粉末
가르침=n.教導,教誨
가맹점=n.加盟店
가뭄=n.旱災
가방=n.包
가사=n.歌詞
가상=n.假想
가수=n.歌手
가스=n.煤氣
가슴=n.胸,胸部
가슴속=n.胸中,心,心裡
가요=n.歌謠
가운데=n.中間,middle
가위=n.剪刀
가을=n.秋天
가이드=n.導遊
가입=n.加入
가입자=n.加入者
가정=n.家庭
가정교사=n.家庭教師,家教
가족=n.家庭成員,家族
가죽=n.皮(動物的)1.동물의 몸을 싸고 있는 껍질을 벗기어 가공한 물품 2.사람이나 동물의 몸을 감싸고 있는 질긴 껍질 3.사람의 피부를 낮잡아 이르는 말
가죽장갑=n.皮手套
가지=n.樹枝;種類
가짜=n.假
가짜와진짜=n.假的和真的
가치=n.價值
가치관=n.價值觀
가톨릭=n.天主教
가혹한형벌=n.殘酷的刑罰
각=n.角
각각=n.各自
각국=n.各國
각기=n.各自
각오=n.覺悟
각자=n.各自
각종=n.各種
간=n.肝
간격=n.間距。指兩個事物之間的空間或隔開的距離。
간부=n.幹部
간섭=n.干涉
간식=n.零食
간장=n.醬油
간접=n.間接
간접적=n.間接的
간판=n.招牌
간호=n.看護,護理
간호사=n.護士
갈등=n.矛盾
갈망=n.渴望
갈비=n.排骨
갈비탕=n.排骨湯
갈색=n.褐色
갈증=n.口渴,渴症목마름
갈피=n.眉目;端倪;端緒
감=n.柿子,-感
감각=n.感覺
감기=n.感冒
감독=n.導演
감동=n.感動,激動
감동적=n.動人的
감사=n.感謝
감사편지=n.感謝信
감상=n.感想
감성=n.感性
감소=n.減少
감수성=n.感受性
감옥=n.監獄
감자=n.馬鈴薯
감자튀김=n.炸薯條
감정=n.感情;感受
감정적=n.情緒化
갑=n.盒子
값=n.價格
강=n.江,河
강남=n.江南
강당=n.講堂
강도=n.搶劫,強盜
강물=n.江水
강박=n.強迫
강변=n.江邊,河邊
강북=n.江北
강사=n.講師
강수량=n.降水量
강아지=n.小狗
강원도=n.江原道
강의=n.講授,上課
강제=n.強迫
강제로=n.強制
강조=n.強調
갖가지=n.種種,各式各樣
갖은=n.各種,所有
개=n.狗,個(數)
개개인=n.每個人
개구리=n.青蛙
개국=n.開國
개나리=n.連翹;迎春花;野百合
개나리꽃=n.狗尾巴花,金鐘花
개미=n.螞蟻
개방=n.開放
개별=n.個別
개별적=n.個別的
개선=n.改善,改進,凱旋
개성=n.個性사람마다의 특성.고유한 성격, 사고방식, 취미 따위
개업=n.開業;開門營業
개월=n.個月
개인=n.個人
개인적=n.人的
개체=n.個體
객관=n.客觀
객관적=n.客觀的
갯벌=n.海邊沙灘;海邊泥灘
걔=n.那傢夥
거=n.東西
거기=n.那裡
거두=n.街頭
거두절미=n.截頭去尾
거리=n.街;材料;距離
거실=n.客廳
거액=n.額
거울=n.鏡子
거죽=n.表面;表皮;封面;封皮
거짓=n.虛假사실이 아님.또는 사실이 아닌 것을 사실처럼 꾸밈.
거짓말=n.謊言
거품=n.泡沫
걱정=n.擔心,操心,憂慮
건=n.件
건강=n.健康
건너=n.對面
건너편=n.對面
건넌방=n.對面房間
건물=n.建築物
건설=n.建設
건조=n.乾燥,枯燥
건축=n.建築,修建。修築。建造。
건축가=n.建築師
건축이론=n.建築理論
걷기=n.起腳,好走
걸림돌=n.絆腳石
걸음=n.腳步
검사=n.檢查
검은색=n.黑色
검정색=n.黑色
검토=n.核對
겁=n.怯,害怕
것=n.的,所謂
겉=n.表面,外表,外相
겉치레=n.排場,場面;外表裝飾。粉飾門面。外表華麗。虛飾。面子上的活兒。
게=n.螃蟹
게시판=n.公告板
게임=n.遊戲
겨레=n.同胞
겨를=n.空隙,空閒,暇；餘暇。組成“-을 겨를”的結構使用
겨울=n.冬天
겨울철=n.冬季
겨자=n.芥菜
격변기=n.激變期
격분=n.憤怒
격식=n.格式;規矩;形式;禮節
견식=n.見識
견해=n.見解
결과=n.結果
결례=n.缺乏禮儀
결론=n.結論
결말=n.結尾；結局；結果
결석=n.缺席
결승=n.決賽
결심=n.決心
결정=n.決定
결함=n.缺點,缺陷,毛病
결혼=n.結婚
결혼기념일=n.結婚紀念日
결혼식=n.婚禮
경계=n.邊界;分界;境界
경고=n.警告
경과=n.經過
경기=n.景氣;比賽
경기도=n.京畿道
경기장=n.比賽場
경력=n.經歷,閱歷
경복궁=n.景福宮(韓國)
경비=n.經費
경색=n.景色
경영=n.經營
경우=n.情況;處境;場合
경쟁=n.競爭
경쟁력=n.競爭力
경제=n.經濟
경제난국=n.經濟窮國
경제력=n.經濟力量
경제적=n.經濟的
경제학=經濟學
경주=n.慶州,韓國城市
경찰=n.員警
경찰관=n.警官
경찰서=n.警署
경치=n.風景
경향=n.傾向,趨勢생각이나 행동, 현상 등에서 나타나는 일정한 방향성.
경험=n.經驗
곁=n.身旁
곁방=n.套房
계곡=n.溪穀
계단=n.樓梯
계란=n.雞蛋
계산=n.計算
계산기=n.計算器
계속=n.繫屬･係屬
계약=n.契約,合同
계절=n.季節
계좌=n.(風水地理，墳墓、房子等)癸坐。 (坐偏東北向偏西南)
계층=n.階層
계획=n.計畫
고갈=n.枯竭
고개=n.額頭
고객=n.顧客
고교=n.高等中學,高中
고구려=n.高句麗,韓國古代三國之一
고구마=n.地瓜
고국=n.祖國,故國
고궁=n.故宮
고금=n.鹽
고급=n.高級
고기=n.肉,魚,肉類
고대=n.古代
고대사=n.古代史
고등학교=n.高中
고등학생=n.高中學生
고려=n.考慮
고모=n.姑媽
고모부=n.姑夫
고무신=n.橡皮鞋,膠鞋
고문=n.拷問
고민=n.苦惱
고뿔=n.傷風
고생=n.辛苦,辛勞,勞苦
고속=n.高速
고속도로=n.高速公路
고속버스=n.高速公交車
고아원=n.孤兒院
고양이=n.貓
고욤=n.軟棗
고음질=n.高音質
고장=n.故障
고적=n.古蹟
고전=n.古典
고전작곡가=n.古典作曲家
고진감래=n.苦盡甘來
고집=n.倔脾氣
고추=n.辣椒
고추장=n.辣椒醬
고춧가루=n.辣椒粉
고통=n.痛苦;難受
고함=n.高喊,大喊
고향=n.故鄉
고화질=n.高畫質
곡=n.曲子
곡식=n.糧食,穀物
골=n.腦
골목=n.巷子
골목길=n.胡同路
골짜기=n.山谷,峽穀
골치=n.腦袋,腦瓜子
골프=n.高爾夫球
골프장=n.高爾夫球場
곰=n.熊
곳=n.地方,地點
곳곳=n.到處
공=n.球
공간=n.空間
공개=n.公開.開放
공격=n.攻擊
공공=n.公共
공교육=n.公共教育
공구=n.工具
공군=n.空軍
공급=n.供給,供應
공기=n.空氣
공동=n.共同
공룡=n.恐龍
공무원=n.公務員
공부=n.學習,念書,用功
공사=n.工事,施工,工程
공성=n.功成,攻城,孔聖,空城
공식=n.正式,公式
공식적=n.正式
공업=n.工業
공연=n.公演, 演出, 表演
공연장=n.演出現場
공용=n.公用
공원=n.公園
공익광고=n.公益廣告
공장=n.工廠
공주=n.公主
공중=n.公眾,公共
공중전화=n.公用電話
공짜=n.免費的
공책=n.記事本,筆記本
공통=n.共通,共同
공통적=n.共同
공통점=n.共同點
공포=n.恐怖두려움과 무서움
공학자=n.工學學者
공항=n.機場
공항버스=n.機場巴士
공해=n.公害
공휴일=n.公休日
과=n.科,專業
과거=n.過去
과로=n.過渡疲勞
과목=n.科目
과실=n.果實
과업=n.任務;課業;學業
과외=n.課外
과일=n.水果
과자=n.餅乾,點心
과장=n.科長
과정=n.課程
과제=n.課題
과학=n.科學
과학원=n.科學院
과학자=n.科學家
과학적=n.科學的
관객=n.觀眾
관계=n.關係
관계자=n.有關人員
관공서=n.國家機關,政府辦公室.官公署나라나 지방 자치 단체의 사무소.
관광=n.觀光
관광객=n.遊客
관광버스=n.遊覽車
관광지=n.觀光景點
관념=n.觀念
관람=n.觀覽,觀看,參觀
관람객=n.觀眾
관련=n.關聯,相關,聯繫
관련링크=n.相關連接
관리=n.官吏;管理
관습=n.習慣
관심=n.關心,感興趣,專注
관심과사랑=n.關心和愛
관심사=n.關心的事情
관점=n.觀點
관찰=n.觀察
광경=n.光景
광고=n.廣告
광장=n.廣場
광주=n.光州,韓國城市
괴로움=n.痛苦(名詞型)
교과서=n.教科書
교내=n.校內
교대=n.交代
교류=n.交流
교문=n.校門
교복=n.校服
교사=n.教師
교수=n.教授
교실=n.教室
교양=n.教養
교외=n.校外；郊外
교육=n.教育
교육비=n.教育費
교육자=n.教育者
교장=n.校長
교재=n.教材
교직=n.教職
교직원=n.教職員
교체=n.交替
교통=n.交通
교통법규=n.交通法規
교통사고=n.交通事故
교포=n.僑胞
교환=n.交換
교회=n.教會
교훈=n.校訓
구=n.九
구15=n.15區
구경=n.欣賞,觀賞,參觀,觀看
구경꾼=n.觀眾
구두=n.皮鞋
구름=n.雲
구멍=n.洞
구별=n.區別,分辨
구분=n.區分
구석=n.隅,角落,偏僻的地方
구석구석=n.每個角落,到處이 구석 저 구석
구성=n.構成;組建;組員;成員
구속=n.約束,拘束
구실=n.作用
구십=n.90
구역=n.區域
구월=n.九月
구입=n.購入
구조=n.構造
구조조정=n.結構調整
구청=n.地方政府
구체적=n.具體的
구추장=n.辣椒醬
국=n.湯
국가=n.國家
국가적=n.國家的
국기=n.國旗
국내=n.國內
국내선=n.國內航線,國內運輸線
국내외=n.國內外
국립=n.國立
국물=n.湯
국민=n.國民
국민적=n.國民的
국민투표=n.國民投票
국부적=n.局部的
국사=n.國史
국산=n.國產
국산품=n.國產品
국수=n.麵條
국어=n.國語
국어국문학과=n.國語文
국왕=n.國王
국적=n.國籍
국정=n.國情
국제=n.國際
국제법=n.國際法
국제선=n.國際線
국제적=n.國際的
국제전화=n.國際電話
국제화=n.國際化
국한=n.局限
국회=n.國會
국회의원=n.國會議員
군=n.郡,是一個行政單位
군계일학=n.鶴立雞群
군대=n.軍隊
군데=n.處,地方
군사=n.軍事
군인=n.軍人
굴레=n.韁套
굴비먹기=n.易如反掌
궁극적=n.終極,最終
권=n.(書的量詞)冊
권고=n.忠告
권리=n.權利
권위=n.權威
권투=n.拳擊
귀=n.耳朵
귀가=n.回家
귀국=n.回國
귀신=n.(迷信)鬼,鬼魂
귓속=n.耳朵裡
규모=n.規模
규범=n.規範,準則
규일=n.休息日
규정=n.規定,規則
규제=n.管制,歸制
규칙=n.規則
규칙적=n.規則的
균등한향상=n.均等的進步
균형=n.均衡
그=pron.那個
그간=n.那段時間
그거=pron.它
그것=n.那個
그곳=n.那裡
그날=n.那天
그네타기=n.蕩鞦韆
그녀=pron.她,那女子
그놈=n.他(卑稱),那傢夥
그늘=n.陰處,陰影
그다음=n.其次,其後,下一個
그대=n.您
그동안=n.近來,期間,這一段
그때=n.那時,那時候
그래픽=n.圖形
그램=n.公克
그런=n.那樣的
그루=n.株,棵,樁子(樹砍後的)
그룹=n.集團,組織
그릇=n.盤子
그리로=n.那裡,哪裡
그리움=n.懷念(名詞型)
그림=n.圖畫
그림의떡=n.畫中餅,形容不可能得到的,空頭支票
그림자=n.影子
그분=n.那位
그사이=n.其間
그이=n.他,她,它,那個人그 사람
그저께=n.前天
그전=n.以前
그쪽=n.對方
그해=n.那年,當年
극=n.極點
극복=n.克服
극작가=n.劇作家
극장=n.劇場
근거=n.根據,證據
근래=n.近來,最近
근로=n.勤勞힘을 들여 부지런히 일함.
근로자=n.勞動者
근무=n.工作
근본=n.根本
근본적=n.根本的
근사한=n.近似的
근성=n.韌性；毅力；意志力
근심=n.掛念;擔心
근원=n.根源
근육=n.肌肉
근처=n.附近
글=n.文字
글쎄=int.或許,可能吧
글쓰기=n.寫作
글씨=n.字;字跡;書法
글자=n.字
금=n.黃金
금강산=n.金剛山,(在朝鮮境內的江原道,是朝鮮半島首屈一指的名山)
금고=n.今昔
금년=n.今年
금메달=n.金質獎章
금세=n.今世,現世
금액=n.金額
금연=n.禁煙
금요일=n.星期五
금지=n.禁止
금지옥엽=n.金枝玉葉
급=n.級
긍정적=n.肯定的
기=n.旗
기13=n.13期
기23=n.23期
기간=n.期間
기계=n.機器,機械
기관=n.機器
기교=n.技巧
기구=n.器具;工具
기꺼움=n.高興
기념=n.紀念
기념일=n.紀念日
기능=n.技能,能力,本事
기능공=n.技工
기대=n.期待,期望。期盼。希望
기도=n.祈禱
기독교=n.基督教
기둥=n.柱,柱子
기량=n.大約；左右；上下。用於數詞後面
기록=n.記錄
기름=n.油
기반=n.基礎
기법=n.方法(講究技巧的)
기본=n.基本
기본바탕=n.基本底子
기본적=n.基本的
기분=n.心情。情緒。心緒。心境。
기쁨=n.喜；高興；喜悅
기사=n.司機
기성세대=n.既成世代,老一代;成年人,中壯年。
기숙사=n.宿舍
기술=n.技術
기술자=n.技術者
기억=n.記憶
기억력=n.記憶力,記性
기업=n.企業
기업소=n.企業
기업인=n.企業家
기여=n.貢獻
기온=n.氣溫
기운=n.力氣,精力
기원=n.起源
기자=n.記者
기적=n.奇跡
기존=n.現有,現存.既有
기준=n.基準,標準
기차=n.火車
기초=n.基礎
기초적=n.初等,基礎的
기침=n.咳嗽
기타=n.吉他
기한=n.期限。時限。期。限期。有期。有限。
기호=n.記號,符號부호
기혼=n.已婚
기회=n.機會,機遇
기획=n.規劃,計畫
기후=n.氣候
긴급=n.緊急
긴장=n.緊張
긴장감=n.緊張感
길=n.路
길가=n.路邊,路旁
길거리=n.街道,大街；街頭。
길손=n.旅客
길이=n.長度
김=n.紫菜
김모=n.金某,表示姓金的人
김밥=n.紫菜飯
김치=n.泡菜
김치담그기=n.醃泡菜
김치찌개=n.泡菜火鍋
김포공항=n.金浦機場
깊이=n.深刻
까닭=n.緣故,原因
까만색=n.黑色
까치=n.喜鵲
깍두기=n.泡蘿蔔塊(泡菜的一種)
깡패=n.強盜集團,匪幫
깨달음=n.醒悟,領會,領悟
깨소금=n.芝麻鹽
껌=n.口香糖
껍질=n.皮
꼬리=n.尾巴
꼬마=n.小鬼(稱呼可愛的小孩)
꼭대기=n.頂部
꼴=n.樣子,熊樣兒
꽃=n.花
꽃다발=n.花環
꽃씨=n.花籽
꽃잎=n.花瓣
꾸중=n.斥責；指責；責備；訓斥
꿀=n.蜂蜜
꿈=n.夢
꿈속=n.夢中
꿩대신닭=n.用相似的代替
끈=n.繩子
끈기=n.粘勁兒, 筋道
끼=n.頓
나=pron.我
나귀=n.驢
나그네=n.過客,對陌生的成人男性的稱呼
나들이=n.串門
나라=n.國家
나름=n.要看怎麼
나머지=n.剩下的
나무=n.樹木
나물=n.蔬菜
나뭇가지=n.樹枝
나뭇잎=n.樹葉발름:나문닙
나비=n.蝴蝶
나이=n.年齡
나중=n.最後,後來；以後
나침반=n.羅盤,指南針,羅針盤나침판
나흘=n.四天
낙서=n.塗鴉,落書,亂寫,亂畫글자나 그림 따위를 장난삼아 아무 데나 쓰거나 그림, 또는 그 글자나 그리는 것
낙엽=n.落葉
낙천적=n.樂觀的
낚시=n.釣鉤
낚시꾼=n.釣魚的人
낚싯대=n.釣竿
난리=n.戰亂,離亂,兵荒馬亂,亂七八糟
난방=n.供暖.暖氣.暖房
난방장치=n.暖氣裝置실내를 따뜻하게 하기 위한 기구
난형난제=n.難兄難弟
날=n.天,日
날강도=n.土匪
날개=n.翅膀
날씨=n.天氣
날짜=n.日子,日期
남=n.男
남녀=n.男女
남대문=n.南大門
남대문시장=n.南大門市場
남동생=n.弟弟
남매=n.兄妹,兄弟姊妹
남미=n.南美洲
남부=n.南部
남북=n.南北,南和北
남산=n.南山
남성=n.男性
남자=n.男性,男人
남쪽=n.南邊
남편=n.丈夫
남학생=n.男同學
남해=n.南海
낭비=n.浪費
낮=n.白天
낱말=n.單詞
내=n.煙
내과=n.內科
내년=n.明年
내달=n.下個月
내부=n.內部
내색=n.表露,流露,expression of one's feeling
내외=n.夫婦
내용=n.內容
내용물=n.內容物
내일=n.明天
내적=n.內部的,內地的
내지=n.乃至
내후년=n.明後年
냄비=n.平底鍋(比如不黏鍋)
냄새=n.氣味
냇물=n.小河
냉동=n.冷凍,凍
냉면=n.冷面
냉방=n.冷炕
냉장고=n.冰箱
너=n.你
너머=n.那邊。後邊
너희=n.你們
넋=n.靈魂
네=n.(回答的時候)是
네거리=n.十字街,十字路
네트워크=n.網路,network
네티즌=n.網友,網民,netizen
넥타이=n.領帶
넷=n.4
넷째=n.第四
녀석=n.傢夥,小子
년=n.年
년대=n.年代
년도=n.年限,年代
노동=n.勞動
노동력수요=n.勞動力需求
노동자=n.勞動者
노란색=n.黃色
노래=n.歌曲
노래방=n.練歌房
노랫소리=n.歌聲
노력=n.努力
노선=n.路線
노인=n.老人
노점상=n.地攤,攤販,露店商
노정=n.路程
노조=n.勞動組合,工會
노트=n.筆記本
녹색=n.綠色
녹음=n.錄音
녹음기=n.錄音機
녹차=n.綠茶
녹화=n.綠化
논=n.水田,稻田
논란=n.爭論,辯難
논리=n.論理,邏輯,調理
논리적=n.邏輯的,論理的,
논문=n.論文
논쟁=n.論爭
놀이=n.遊戲
놀이터=遊戲場
놈=n.傢夥
농구=n.籃球
농구선수=n.藍球選手
농담=n.玩笑
농민=n.農民
농부=n.農夫
농사=n.農事
농사일=n.農活兒
농산물=n.農產品
농업=n.農業
농작물=n.農作物
농장=n.農場
농지=n.措辭
농촌=農村
높은곳=n.高處
높이=n.高,高度,高低
뇌=n.腦
뇌장애=n.大腦疾病
누나=n.姐姐(男稱女)
누명=n.黒鍋,連累
눈=n.雪,眼睛
눈가=n.眼邊
눈길=n.視線
눈동자=n.瞳孔
눈물=n.眼淚
눈병=n.眼病
눈빛=n.雪色
눈썹=n.眉毛
눈앞=n.眼前
눈치=n.眼色,神色
뉴스=n.新聞
뉴욕=n.紐約
느낌=n.感覺
늑대=n.狼的一種
능동적=n.主動的
능력=n.能力,本領。本事
늦가을=n.晚秋
늦은밤=n.深夜
다람쥐=n.松鼠
다리=n.橋,腿
다방=n.茶房,茶館
다섯=n.5
다섯째=n.第五
다수=n.多數
다양성=n.多樣性
다음=n.然後
다음날=n.次日
다음해=n.明年
다이어트=n.減肥
다툼=n.鬥爭,角鬥
다행=n.僥倖,幸虧,幸好
단계=n.階段(段階)
단골=n.常往來,熟識,熟客,常客
단골손님=n.老顧客
단기간=n.短時間
단독=n.單獨,獨自
단맛=n.甜味兒
단순=n.單純,簡單;單一
단어=n.單詞
단오=n.端午
단위=n.單位
단점=n.缺點
단체=n.團體
단편=n.短篇
단풍=n.楓葉
달=n.月亮
달걀=n.雞蛋
달러=n.美元미국의 화폐
달력=n.月歷
달리기=n.跑步
달빛=n.月光
닭=n.雞
닭고기=n.雞肉
닭껍질=n.雞皮
담=n.圍牆
담그기=n.醃,泡
담당=n.擔當,負擔,承擔
담당자=n.負責人
담배=n.(香)煙
담요=n.毯子
담임=n.擔任,擔當
담임선생=n.班導
담장=n.圍牆
답=n.答,回答,解答
답변=n.答辯,回答
답서=n.回信
답장=n.回信
닷새=n.五天
당국=n.當局
당근=n.胡蘿蔔
당시=n.當時
당신=n.你,您(第二人稱代詞)
당장=n.當場,當時
대=n.台,代,歲
대가=n.代價
대강=n.代講.代課
대개=n.大概,概要
대구=n.鱈魚
대규모=n.大規模
대기=n.大氣
대기업=n.大公司
대기오염=n.大氣污染
대낮=n.白晝
대다수=n.大多數
대답=n.回答
대도시=n.大城市
대략=n.宏圖大略;概要
대량=n.大量,批量
대로=n.代勞
대륙=n.大陸
대립=n.對立,矛盾
대문=n.本文,正文,大門
대부분=n.大部分
대비=n.對比
대사=n.臺詞
대사관=n.大使館
대상자=n.對象
대신=n.替代,代替
대여섯=n.五六(個)
대외적목적=n.對外的目的
대응=n.相對,對立
대인관계=n.人際關係,對人關係,人緣
대장=n.鐵匠
대접=n.接待
대중=n.大眾
대중가요=n.大眾歌謠
대중교통=n.大眾交通
대중문화=n.流行文化
대중적=n.大家的,大眾的
대책=n.對策
대체로=n.替代,交替
대추=n.大棗
대출=n.出借,出租
대통령=n.總統
대표=n.代表
대표적=n.代表性
대학=n.大學
대학교=n.大學
대학교수=教授
대학생=n.大學生
대학생활=n.大學生活
대학원=n.研究生院
대학원생=n.研究生
대한민국=n.大韓民國
대합실=n.待合室,候機、車、船室
대형=n.隊形;大型
대화=n.對話
대회=n.大會
댁=n.宅(“집”或“가정”的敬語)宅邸, 府上
댐=n.堤壩
더러=n.一部份
더위=n.暑熱,hotness暑；暑氣
더하기=n.加法
덕택=n.恩情,恩德,恩惠,德澤,多虧,託福
덜기=n.減法
덩어리=n.塊
데이트=n.約會
도=n.道,朝鮮半島由8個道組成,類似於中國的省
도구=n.道具,工具。用具。器具。器物
도덕=n.道德
도덕성=n.道德
도독=n.荼毒;毒害
도둑=n.小偷,盜賊
도로=n.道路,馬路,公路
도마=n.案板,切菜板,沾板
도망=n.逃亡,逃走,逃跑
도서관=n.圖書館
도시=n.城市
도시락=n.便當,飯盒
도심=n.市中心
도우미=n.幫助,導購,解說員,服務員,志願者,援助者
도움=n.幫助
도움말=n.幫助
도입=n.導入,採用,吸取
도자기=n.陶瓷,瓷器
도적=n.盜賊
도전=n.挑戰
도중=n.途中。路上。過程中。
도착=n.到達
도쿄동경=n.東京,Tokyo
독감=n.重感冒,流感
독단=n.獨斷,武斷
독립=n.獨立
독백=n.獨白
독서=n.讀書
독일=n.德國
독일어=n.德語
독재=n.獨裁
독재자=n.獨裁者
독창적=n.獨創性
돈=n.錢
돌파구=n.突破口
동=n.洞
동록금=n.註冊費
동문서답=n.答非所問
동반자=n.同伴
동서고금=n.古今中外
동아리=n.(學生共同愛好而成立)社團
동안=n.期間,時期,時候
동양=n.東洋
동영상=n.(電腦)視頻
동작=n.動作
동정=n.動靜
동쪽=n.東邊
동창생=n.同班同學
동포=n.同胞
동호회=n.同好會;協會;出社會後具有相同興趣或愛好的團體
동화책=n.童話書
돼지=n.豬
돼지고기=n.豬肉
되다=變成,成為
됨됨이=n.為人,人品
두시=二點,二點,two o'clock
두어=n.兩三個
둔재=n.蠢才
뒷모습=n.背影
뒷문=n.後門
뒷산=n.後山
드라마=n.電視劇,來自drama
드라이=n.烘乾
드레스=n.衣服,dress
득점=n.得分
들=n.田野
들불=n.野火
등=n.背;等
등록되다=被登記,註冊
디자인=n.設計,design
디지털카메라=n.數碼相機,digital camera
따귀=n.耳光
따님=n.女兒
따위=n.之類,such as
딴=n.別的
딸기=n.草莓
딸아이=n.妞,小女
땅속=n.地下
땅콩=n.花生
때=n.時候
때문=n.原因；理由
떼=n.群
뚜껑=蓋子;俗稱帽子
뚱뚱한사람=n.胖人
뜰=n.院子
렌즈=n.鏡片
리더십=n.領導力,leadership
리모컨=n.遙控,remocon좀 떨어진 곳에 있는 기기나 장치에 신호를 보내어 그것을 작동하게 하는 기구
리모컨(콘)=n.遙控,remocon
마누라=n.老婆
마늘=n.大蒜
마당=n.院子
마디=n.節
마라톤=n.馬拉鬆
마련=n.籌集,準備
마루=n.韓屋的木地板,板炕, 不通火, 里外屋间铺着木板的地方전통 가옥에서, 방과 방 사이나 방 앞을 지면으로부터 높이 떨어지게 하여 널빤지를 길고 평평하게 깐 공간
마리=n.只(動物量詞包括鳥類,魚類和昆蟲)
마무리=n.事情尾巴;結尾;成,結束
마사지=n.按摩
마약=n.毒品
마요네즈=n.沙拉醬,蛋黃醬,mayonnaise
마을=n.村子
마음=n.心靈,心情
마음가짐=n.心;心情;心態;意志
마음속=n.心裡
마음씨=n.心地;心眼
마이크=n.麥克風
마중=n.迎接,出迎
마지막=n.最後。末了。最終。終局。結尾。
마찰=n.摩擦
마크=n.商標
막강한영향력=n.很強的影響力
막걸리=n.馬格利酒(米酒的一種)
막내=n.老麼
만=n.滿
만남=n.遇見
만두=包子,水餃
만세=n.萬歲
만일=n.萬一
만점=n.滿分
만족=n.滿足,滿意
만주=n.滿洲
만화=n.漫畫
만화가=n.漫畫
맏딸=n.長女
말=n.馬;底
말기=n.褲腰,裙腰
말다툼=n.吵架;舌戰
말소리=n.說話聲
말썽=n.紛爭,惹事,搗蛋
말씀=n.話,言語
말투=n.語氣,口氣
맘=n.心
맛=n.味道
맛깔=n.味道
망원경=n.望遠鏡
맞돈=n.現金,現錢.現款。
맞은편=n.對面
매=n.棒子
매너=n.禮節
매년=n.每年
매달=n.每個月
매력=n.魅力
매스컴=n.公眾媒介
매장=n.售貨櫃檯,埋葬,每張
매주=n.每週
매체=n.媒體
맨=n.最,光著
맹수=n.猛獸
머리=n.頭髮
머리말=n.序,序言,前言,卷頭語
머리카락=n.頭髮,髮絲
머리칼=n.頭髮
머릿속=n.腦子裡;腦中;腦海
머저리=n.草包,傻子
먹이=n.飼料,餌
먼지=n.塵土,灰塵
멋=n.風姿,漂亮,帥氣
메뉴=n.菜單
메모=n.記錄
메시지=n.資訊
메일=n.郵件,電郵
며느리=n.媳婦
며칠=n.幾天
면=n.棉布或棉線
면담=n.面談
면적=n.面積
면접=n.面試
면제=n.免除
멸종=n.滅種,滅亡생물의 한 종류가 아주 없어짐, 또는 아주 없애 버림
멸치=n.鯷魚,海蜒,鳳尾魚
명=n.名
명년=n.明年
명단=n.名單
명동=n.明洞
명령=n.命令
명령어=n.命令
명산=n.名山
명예=n.名譽；名聲
명의=n.名義,名醫
명절=n.節日
명칭=n.稱
명품=n.名貴的物品뛰어나거나 이름이 난 물건이나 작품
명함=n.名片
명화=n.名畫
몇몇=n.幾個,某些
모=n.某,母,秧,毛,棱角
모금=n.口
모기=n.蚊子
모니터=n.監聽員,監察員 (電臺、報社、公司)評議員。監督員。
모델=n.模特
모든=n.所有
모래=n.沙子
모레=n.後天
모범=n.模範
모습=n.模樣,型態,樣子
모양=n.樣子;模樣;長相,外表
모임=n.聚會;集會
모자=n.帽子
모집=n.招,招募
모친=n.媽媽
모퉁이=角落,隅,corner
모형=n.模型
목=n.脖子
목걸이=n.項鍊,項圈
목덜미=n.脖頸
목록=n.目錄
목사=n.牧師
목소리=n.嗓音
목숨=n.命,人或者動物的生命
목요일=n.星期四
목욕=n.洗澡
목욕탕=n.澡堂;浴池
목은해=n.去年
목적=n.目的,目標
목표=n.目標
몸=n.身體
몸매=n.體型;身材;身姿,身段;體態
몸무게=n.體重
몸살=n.病痛,四肢酸痛,累病,累倒,渾身難受。指身體疲勞、酸痛、虛弱、無力的病症
몸소=n.親手
몸속=n.體內
몸짓=n.身體的動作
몸통=n.身軀,塊頭
묘사=n.描寫
묘지=n.墓地；墳地
무=n.蘿蔔
무게=n.重量
무관심=n.不關心
무궁화=n.無窮花,木槿;無窮花是韓國國花
무기=n.武器
무늬=n.紋理,紋；紋路
무대=n.舞臺
무더위=n.酷暑
무덤=n.墳墓
무렵=n.時候
무례=n.無禮
무료=n.免費,無償,無料
무릎=n.膝蓋
무리=n.群
무순=n.對立,矛盾,無順,無順序
무술=n.武術
무어=n.什麼,何
무엇=n.什麼(what)
무엇보다도=n.最中重要的
무역=n.貿易
무용=n.舞蹈
무용가=n.舞蹈家
무용수=n.舞蹈演員
무인=n.武人,武者
무제한=n.無限
무지개=n.虹,彩虹
무형=n.無形
문=n.門
문구=n.文句,句子
문밖=n.門外
문법=n.文法
문병=n.探病,看病
문서=n.文件,公文
문자=n.文字
문장=n.文章
문제=n.難題;問題
문제점=n.問題
문학=n.文學
문학작품=n.文學作品
문학적=n.文學的
문화=n.文化
문화재=n.文化遺產
문화적=n.有文化的
물=n.水
물가=n.物價
물건=n.東西,物
물결=n.波浪,水波
물고기=n.魚
물기=n.水氣;水分
물론=n.當然
물리=n.物理
물리학=n.物理學
물살=n.水勢,水流,(水)溜
물속=n.水中;水裡
물음=n.問,問題,詢問,提問
물질=n.物質
물질적=n.物質的
물체=n.物體
뭘=pron.什麼,무엇을的縮寫
미=n.美
미국=n.美國
미니=n.小型的
미디어=n.媒體
미래=n.未來
미만=n.未滿
미사일=n.導彈missile
미소=n.微笑
미술=n.美術
미술관=n.美術館
미스=n.失敗,失策
미역=n.海帶
미용사=n.美容師
미용실=n.美容室
미움=n.嫌棄
미인=n.美人,美女
미인화=n.美女圖
미지수=n.未知數
미터=n.公尺
미팅=n.相會,相遇
미혼=n.未婚
민간=n.民間
민담=n.民間故事,民間傳說,民談
민물=n.淡水
민속=n.民俗
민족=n.民族
민주=n.民主
민주주의=n.民主主義
민주화=n.民主化
믿음=n.相信
밀가루=n.麵,麵粉
밀리미터=n.毫米
밑=n.底
밑바닥=n.底,底面
바=n.粗繩
바가지=n.瓢
바구니=n.籃子
바깥=n.外邊；外面막히거나 가려지지 않은 길거리나 들판 따위의 곳.
바깥쪽=n.外邊
바나나=n.香蕉
바늘=n.針
바다=n.大海
바닥=n.底,底部;底面
바닷가=n.海邊
바닷물=n.海水
바람=n.風
바보=n.白癡
바위=n.岩石
바이러스=n.病毒
바이올린=n.小提琴
바지=n.褲子
바퀴=n.輪子
바탕=n.材料;質地
박대=n.薄待;虧待;冷待,慢待
박물관=n.博物館
박사=n.博士
박수=n.拍手
박스=n.箱子
밖=n.外
반=n.半
반대=n.反對,相反
반대편=n.對面
반말=n.用非敬語說話
반면=n.另一方面
반발=n.彈回
반복=n.反復
반색=n.高興,歡喜,喜色
반성=n.反省
반응=n.反應
반장=n.班長
반전평화행사=n.反戰和平活動
반죽=n.和,揉(麵)
반지=n.戒指,指環
반찬=n.(伴餐)小菜,菜餚
받침=n.墊子,收音,終聲
발=n.腳
발가락=n.腳趾
발걸음=n.腳步
발견=n.發現
발길=n.腳步앞으로 움직여 나아가는 발
발끝=n.腳尖
발달=n.發達,發展
발등=n.腳背
발레=n.芭蕾舞
발목=n.腳脖子
발바닥=n.腳掌,腳底
발생=n.發生
발원=n.發源
발음=n.發音
발자국=n.腳印
발전=n.發展
발톱=n.腳指甲
발표=n.發表
밤=n.夜
밤낮=n.晝夜,日夜
밤새=n.夜間
밤색=n.褐色,栗色
밤중=n.半夜
밤하늘=n.夜空
밥=n.飯
밥그릇=n.飯碗
밥맛=n.飯味
밥상=n.飯桌
밥솥=n.飯鍋
밧줄=n.麻繩,繩索,繩子
방=n.房間
방도=方法,方法,辦法,途徑,方途,方道
방면=n.方面
방문=n.房門
방바닥=n.地板
방법=n.方法,辦法
방송=n.廣播,播放
방송국=n.廣播局
방송사=n.廣播電臺,放送局
방식=n.方式
방안=n.房內
방어=n.防禦
방어벽=n.防禦牆
방울=n.鈴;珠
방지=n.防止
방책=n.計策
방학=n.假期,放假
방해=n.防礙
방향=n.方向어떤 방위나 지점을 향한 쪽.
배=n.肚子,梨
배경=n.背景
배구=n.排球
배꼽=n.肚臍
배달=n.配送
배드민턴=n.羽毛球
배우=n.演員
배우자=n.配偶,伴侶
배추=n.白菜
배추김치=n.白菜泡菜
배치=n.佈置
백=n.白,白色
백두산=n.長白山
백색=n.白色
백성=n.百姓
백인=n.白人
백제=百濟
백제문화=n.百濟文化,百濟是古代的國家名稱
백주=n.白晝,白晝。白天。大白天。光天化日
백화점=n.百貨店
뱀=n.蛇
뱃사람=n.船夫,船員
버릇=n.習慣
버섯=n.蘑菇
버스=n.大客車,公車
버스정류장=n.公車站
버터=n.黃油,奶油
번=n.回
번개=n.閃電
번역=n.翻譯(主要指筆譯)
번역기=n.翻譯器
번지=n.門牌號
번째=n.次,回
번호=n.號碼
벌=n.蜜蜂
벌금=n.罰款
벌레=n.蟲子
범법행위=n.違法行為
범위=n.範圍
범인=n.凡人
범죄=n.犯罪
법=n.法
법률=n.法律
법원=n.法院
법적=n.法律的
법정모독죄=n.褻瀆法庭罪
법칙=n.法則
법통=n.法統
벗=n.朋友,友人
베개=n.枕頭
베이징북경=n.北京,Beijing
벤치=n.長椅,長凳
벨트=n.傳送帶,皮褲帶
벼=n.稻子
벽=牆
변경=n.變更
변동=n.變動
변명=n.狡辯
변색=n.變色
변신=n.變身,搖身一變,轉型
변호사=n.律師
변화=n.變化
별=n.星星
별도=n.另外,別途,另行
별명=n.外號
별세=n.別逝,死,去世,去逝
별일=n.特別的事,其他的事
병=n.病
병실=n.病房
병아리=n.小雞, 雞雛。雛雞
병원=n.醫院
보고=n.報告
보고서=n.報告書
보관=n.保管
보금자리=n.巢
보너스=n.獎金,獎勵
보도=n.報導
보라색=n.青紫色
보람=n.意義,價值
보름=n.十五日,十五號
보리=n.大麥
보살핌=n.照顧
보상=n.補償
보성차=n.寶城茶,寶城是韓國有名的產茶的地區
보수=n.報酬
보수적=n.保守的
보안=n.保安
보자기=n.小包,包裹,小包袱
보장=n.保障,保證
보전=n.保存,保全
보조=n.步調
보존=n.保存
보편성=n.普遍性
보편적=n.普遍的
보폭=n.步幅
보험=n.保險
보험증=n.保險證
보호=n.保護
복=n.福
복도=n.走廊,複道
복사=n.複寫,複印
복숭아=n.桃子
복습=n.復習
복지=n.福利,幸福,福利
볶음=n.炒(菜)
볶음밥=n.炒飯
본=n.榜樣
본격적=n.正式
본디=n.本來,當初,原來
본래=n.本來
본부=n.本部,總部
본사=n.總社
본성=n.本性
본인=n.本人
본전=n.本錢
본질=n.本質
볼=n.火
볼고기=n.烤肉
볼링=n.保齡球
볼일=n.要做的事,要辦的事
볼펜=n.原子筆,圓珠筆
봄=n.春天
봄꽃=n.春花
봉사=n.服務,奉獻
봉지=n.袋子
봉투=n.信封
부=n.部
부근=n.附近
부끄러운일=n.丟臉的事情,不好意思的事情
부끄러움=n.害羞；臉紅。
부담=n.承擔(費用)；支付；負擔
부대=n.部隊
부동산=n.房地產
부모=n.父母
부모님=n.父母
부문=n.部門
부부=n.夫婦
부분=n.部份
부분적=n.部分的,局部的
부산=n.釜山,(韓國第二大城市,港口城市)
부상=n.負傷,受傷
부서=n.部門,部署
부엌=n.廚房
부위=n.地方,部位
부유층=n.富有(階)層
부인=n.夫人
부자=n.父子,富翁
부작용=n.副作用
부잣집=n.有錢人
부장=n.部長
부재=n.部件,構件
부정=n.舞弊,不正,非法,不正當
부정적=n.反對,否定的
부정적인인식=n.消極的認識
부족=n.部族
부채=n.扇子
부처=n.佛,佛像
부친=n.爸爸
부탁=n.囑託,託付, 拜託, 請求
부품=n.配件,部件
부피=n.容積;體積
부화뇌동=n.人云亦云
부회장=n.副會長
북=n.北
북교=n.佛教
북부=n.北部
북쪽=n.北邊
북한=n.北韓
분=n.位
분권화=n.分權化
분노=n.憤怒
분량=n.分量
분리=n.分離
분명=n.分明
분석=n.分析
분석적=n.分析的
분실=n.遺失
분야=n.領域
분위기=n.氣氛
분필=n.粉筆
분홍색=n.粉紅色
불=n.火
불가분의=n.不可分離,不可分割
불고기=n.燒烤,烤肉
불교=n.佛教
불꽃=n.火花
불량품=n.不合格產品;劣質品
불만=n.不滿
불법=n.不法;佛法
불빛=n.火花
불쌍한신세=n.可憐的處境
불안=n.不安
불우이웃=n.不幸的鄰居
불의=n.不義
불이익=n.損壞
불펜=n.原子筆
불편=n.不便,不舒服
불평=n.不滿,委屈,不平.牢騷
불행=n.不幸
불황=n.不景氣,蕭條
브랜드=n.商標
블라우스=n.寬大的罩衫
비=n.雨
비감=n.悲哀
비결=n.秘訣
비공식적=n.非正式的
비관적=n.悲觀的
비교=n.比較
비교적=adv.n.比較的1.일정한 수준이나 보통 정도보다는 더 2.둘 이상의 것을 서로 또는 어떤 것과 다른 것을 견주어 보는 3.둘 이상의 것을 서로 또는 어떤 것과 다른 것을 견주어 보는 것
비극=n.悲劇
비난=n.非難,指責,刁難
비누=n.肥皂
비닐=n.塑膠
비닐봉지=n.塑膠袋
비둘기=n.鴿子
비디오=n.錄影帶,video
비만=n.肥胖,肥滿
비명=n.碑銘
비밀=n.秘密,機密
비바람=n.風雨
비빔밥=n.拌飯
비상=n.非常,緊急
비상시=n.非常時期
비서=n.秘書
비용=n.費用
비위=n.口味
비율=n.比率
비일비재=n.數不勝數
비정규직=n.非正式職位,派遣工,臨時工
비중=n.比重,比例
비타민=n.維他命
비판=n.批評；批判。잘못된 점을 지적하여 부정적으로 말함
비판적=n.批判的
비행=n.惡行,胡作非為
비행기=n.飛機
비행장=n.飛機場
빈민=n.貧民
빈익빈부익부=n.貧者越貧,富者越富
빌딩=n.大廈
빗=n.梳子머리카락이나 털의 결을 가지런히 하는 데 쓰는 도구
빗길=n.下雨的路
빗물=n.雨水
빗방울=n.雨點兒,雨滴
빗줄기=n.雨滴
빙판=n.冰面
빚=n.債
빛=n.光
빛깔=顏色
빨간색=n.紅色
빨래=n.髒衣服(需要洗的)
빵=n.麵包
뺨=n.兩腮
뼈=n.骨骼
뿌리=n.根
사=4,(china)
사건=n.事件,案件
사계절=n.四季
사고=n.事故,思考
사고력=n.思維能力
사과=n.蘋果
사교육=n.私立教育
사기=n.瓷器
사나이=n.男子
사냥=n.打獵,狩獵
사달=n.事故
사람=n.人
사랑=n.愛
사례=n.事例,例子
사료=n.飼料모이
사립=n.私立
사립대학=n.私立大學
사막=n.沙漠
사망=n.死亡
사망자=n.死者
사모님=n.師母
사무=n.事務,業務
사무소=n.辦事處,事務所；管理處
사무실=n.辦公室
사무직=n.辦公職
사물=n.私物
사방=n.四方,四周
사상=n.思想
사생활=n.私生活
사설=n.社論,社評
사소한일=n.瑣事
사슴=n.鹿
사실=n.事實
사실상=n.實則,實際上
사십=n.40,(china)
사업=n.事業,工作
사업가=n.企業家,實業家
사업자=n.個體戶,創業者,做事業的人
사용=n.使用
사용법=n.使用方法
사용자=n.使用者
사원=n.寺院
사월=n.四月
사위=n.女婿
사이=n.中間,間隔
사이사이=n.中間;之間
사자=n.獅子
사장=n.老闆
사전=n.詞典
사정=n.事情
사진=n.照片
사진기=n.照相機
사촌=n.堂兄弟,堂姐妹
사춘기=n.青春期
사탕=n.糖
사투리=n.方言,俚語
사표=n.師範,辭呈,辭職書
사회=n.社會
사회생활=n.社會生活
사회자=n.主持人
사회적=n.社會的
사회주의=n.社會主義
사회학=n.社會學
사흘=n.三天
산=n.山
산길=n.山路
산꼭대기=n.山頂
산넘어산=n.過了一關又是一關,比喻困難重重,越來越難
산부인과=n.婦產科
산성비=n.酸雨
산소=n.氧氣
산속=n.山中
산업=n.產業
산업사회=n.產業社會
산책=n.散步
산허리=n.山腰
살=n.歲
살림=n.家務;生計
살림살이=n.過日子;家庭生活;家務
살인=n.殺人
삶=n.生活,人生
삼=3,(china)
삼계탕=n.蔘雞湯
삼국=n.三國,韓國歷史上的三國是高麗,新羅和百濟(고려,신라,백제)
삼림=n.森林
삼십=30,(china)
삼월=n.三月
삼촌=n.叔叔
삽시=n.瞬間,霎時
상=n.相
상관=n.相關
상금=n.獎金
상담=n.商談;談論；諮詢
상당=n.相當,合,抵
상당수=n.相當數量
상대=n.對手
상대방=n.對方
상대성=n.相對性
상대적=n.相對
상대편=n.對方
상류=n.上游
상반기=n.上半期
상부상조=n.相扶相助,互相幫助
상상력=n.想像力
상식=n.常識
상실감=n.失落感,喪失感
상업=n.商業
상인=n.商人
상자=n.箱子
상점=n.商店
상징적=n.象徵的
상처=n.傷處,傷口
상추=n.生菜
상태=n.常態,狀態
상표=n.商標
상품=n.商品
상호=n.相互,相互
상황=n.狀況,情況
새=n.新
새끼=n.小畜牲
새로운차원=n.新的角度,新的起點
새벽=n.淩晨,清晨
새소리=n.鳥聲,鳥語
새우=n.蝦
새해=n.新年
새해인사=n.新年祝辭,新年好
색=n.顏色
색깔=n.色彩
색연필=n.彩色鉛筆
색채=n.色澤
샌드위치=n.三明治
생=n.生,生存
생각=n.思考,想法
생기=n.生氣,朝氣,活力
생김새=n.長相,相貌,模樣
생명=n.生命
생물=n.生物
생방송=n.現場直播
생산=n.生產
생산력=n.生產力
생산자=n.生產者
생선=n.海鮮,新鮮的魚
생선구이=n.烤海鮮
생선회=n.生魚片
생신=n.生日,這是用於老者或者長輩的敬語.非敬語是생일
생원=n.書生,年老儒生的尊稱
생일=n.生日
생일초대메모=n.生日邀請備忘錄
생채기=n.傷痕
생활=n.生活
생활비=n.生活費
생활수준=生活水準
생활예절=n.生活禮儀
생활용품=n.生活用品
생활화=n.生活化실생활에 옮겨지거나 생활 습관이 되는 것
생활환경=n.生活環境
샤워=n.淋浴
서구=n.西歐,西方
서구적=n.西歐的,歐式的
서너=n.三四
서랍=n.抽屜
서류=n.文檔
서른=n.30
서리=n.霜
서명=n.署名,簽名
서민=n.庶民
서부=n.西部
서비스=n.服務
서양=n.西方
서양인=n.洋人
서예=n.書法
서울=n.首爾
서울역=n.首爾站
서유럽=n.西歐
서적=n.書籍
서점=n.書店
서쪽=n.西邊
서클=n.社團,小組,組
석사=n.碩士
석유=n.石油
선=n.線
선거=n.選舉
선견지맹=n.先見之明
선과악=n.善和惡
선물=n.禮物
선박=n.加倍
선배=n.前輩
선생=n.老師
선생님=n.老師
선수=n.選手
선원=n.船員
선장=n.船長
선전=n.宣傳
선진=n.先進,發達
선진국=n.發達國家
선참=n.先
선천적=n.先天的
선택=n.選擇
선풍기=n.電風扇
설=n.元旦
설거지=n.洗碗,指飯後收拾飯桌
설날=n.新年,元旦
설렁탕=n.雜燴湯
설명=n.說明
설문=n.問卷(用於統計某些資訊的)
설비=n.設備
설사=n.瀉
설악산=n.雪嶽山(韓國名山,江原道,海拔1708米主峰白青峰)
설치=n.設置
설탕=n.白糖
섬=n.島
성=n.省
성격=n.性格
성경=n.聖經
성경책=n.聖經
성공=n.成功
성공여부=n.成功與否
성공적=n.成功(的)
성남=n.城南
성년=n.成年
성당=n.聖堂,教堂(天主教)
성명=n.名字
성별=n.性別
성인=n.成年人
성장=n.成長
성적=n.成績
성지=n.聖地
성질=n.性子;脾氣
성차별=n.性別差異
성탄절=n.耶誕節
성폭행=n.性暴力
성함=n.姓名
성화=n.德化;神聖化
세계=n.世界
세계관=n.世界觀
세계적=n.世界的
세계평화=n.世界和平
세균=n.細菌
세금=n.稅金
세기=n.世紀
세대=n.世代,指的是一個世代的人
세로=n.縱的
세미나=n.研討會,課堂討論
세상=n.世界,天下
세상물정=n.人情世故
세상에=n.世上,世界,天下,社會
세수=n.洗臉
세월=歲月
세월이약=n.歲月是撫平一切的良藥
세제=n.稅制
세차=n.洗車,租車
세탁=n.洗滌
세탁기=n.洗衣機
세탁소=n.洗衣店
세트=n.舞臺裝置
센터=n.中心,center
센티미터=n.公分
셈=n.數數,計算
셋=3
셋째=第三
소=n.牛
소개=n.介紹
소규모=n.小規模
소극적=n.消極的
소금=n.鹽
소나기=n.陣雨
소나무=n.松樹
소낙비=n.陣雨
소녀=n.少女
소년=n.少年
소득=n.收入,所得
소량=n.少量
소리=n.聲音
소망=n.希望.心願。願望。希望
소매=n.衣袖
소문=n.傳聞
소부분=n.少部份,小部分
소비=n.消費
소비량=n.消費量
소비자=n.消費者
소생=n.復蘇。複生。回生
소설=n.小說
소설가=n.小說家
소속=n.所屬
소수=n.小數
소스=n.醬,調汁
소시지=n.香腸
소식=n.消息
소아과=n.小兒科
소외계층=n.(被社會)疏遠的階層
소용=n.用處
소원=n.所願,希望,心願；願望。
소위=n.所為,行為
소유=n.所有
소유자=n.所有者
소음=n.噪音,騷音시끄러운 소리.
소재=n.新聞;文章所載
소주=n.燒酒,白酒
소지품=n.攜帶品
소질=n.素質
소파=n.沙發
소포=n.包裹
소풍=n.兜風,散步;郊遊
소프트웨어=n.軟體
소형=n.小型
소화=n.消化
속=n.裡面겉이나 테두리로부터 가운데를 향하는 쪽의 공간
속담=n.俗語,諺語
속도=n.速度
속마음=n.內心
속셈=n.心計
속옷=n.內衣
손=n.手
손가락=n.手指
손길=n.手
손녀=n.孫女
손님=n.客人
손등=n.手背
손목=n.手腕兒
손바닥=n.手掌
손발=n.手和腳
손뼉=n.鼓掌,拍手
손수건=n.手帕
손실=n.損失
손자=n.孫子
손잡이=n.手把
손질=n.修繕
손톱=n.指甲
손해=n.損害
솔=n.松樹
솜=棉花
솜씨=n.才藝,能力
송아지=n.牛犢
송이=n.朵,花的量詞
송편=n.蒸糕,鬆糕
쇠=n.鐵
쇠고기=n.牛肉
쇼=n.展示會,展覽會
쇼핑=n.購物
수=n.招數,招兒
수건=n.毛巾,手巾
수고=n.辛苦,麻煩
수년=n.年
수단=n.手段
수도=n.水道,自來水
수도권=n.首都範圍
수도꼭지=n.水龍頭
수돗물=n.自來水
수동적=n.被動的
수만=n.數萬；幾萬
수매=n.購買
수면=n.水面
수면부족=n.睡眠不足
수명=n.壽命
수박=n.西瓜
수백=n.百
수분=n.水分
수사=n.搜查；偵查。
수상=n.水上
수석=n.首席;第一名
수소에너지=n.氫能源
수수경단=n.紅豆沙糕(點心,紅豆沙塗在用年糕上), [식품용어] 高粱湯圓
수수께끼=n.謎語
수수방관=n.袖手旁觀
수술=n.手術
수십=n.十
수업=n.上課
수염=n.鬍鬚
수영=n.游泳
수영장=n.音{水泳場} n.游泳池
수요=n.需要
수요일=n.星期三
수입=n.進口
수입품=n.輸入品
수재=n.秀才
수저=n.匙和筷
수준=n.水準,水準
수집=n.收集,收藏
수천=n.千
수출=n.出口,輸出
수컷=n.公的,雄的
수표=n.支票
수필=n.隨筆
수학=n.學習
수해복구=n.水災復原
수험생=n.考生,受驗生
수화기=n.耳機,話筒
숙녀=n.淑女
숙소=n.住處,住所
숙제=n.作業
순간=n.瞬間
순간적=n.瞬間的
순서=n.順序
순수=n.純粹
순식간=n.瞬間,刹那
순위=n.順序
숟가락=n.勺子;飯杓
술=n.酒
술병=n.酒瓶
술자리=n.酒席
술잔=n.酒杯
술집=n.酒家
숨=n.氣息
숫자=n.數字
슈퍼마켓=n.超市,supermarket
스님=n.和尚
스모그=n.煙霧
스무=n.20
스물=20
스승=n.師傅,老師
스웨터=n.毛衣
스위치=n.電燈開關,電動門
스케이트=溜冰鞋
스케줄=n.計畫,日程
스키=n.滑雪
스키장=n.滑雪場
스타=n.有名的演員或運動員,名人,明星
스타일=n.風格,style
스튜디오=n.攝影棚
스트레스=n.壓力(工作或生活帶來的)
스포츠=n.體育
스포츠음료=n.運動飲料
습관=n.習慣
습기=n.潮氣,潮濕
승강기=n.電梯(這個詞的來源是漢語的升降機,엘리베이터是來自美語 的 elevator,還有一個較生僻的單詞是리프트,英國人把 電梯叫做lift) * 엘리베이터是常用的叫法.
승객=n.乘客
승리=n.勝利
승부=n.勝負,輸贏
승용차=n.轎車
승진=n.(工作職位上的)晉升
시=n.時;市
시각=n.時刻,時候
시간=n.時間
시계=n.錶
시골=n.鄉下,農村
시금치=n.菠菜
시기=n.時期;時候
시나리오=n.電影劇本
시내=n.市內(繁華地段),小河,小溪
시내버스=n.市內巴士
시대=n.時代
시대적=n.時代的
시댁=n.婆家
시도=n.詩
시디롬=n.光碟,CD-ROM
시름=n.憂慮,憂愁,心事,操心,擔心
시리즈=n.系列,叢書
시멘트=n.水泥
시민=n.市民
시부모=n.公婆,舅姑
시선=n.線
시설=n.設施,設備
시설물=n.設施
시스템=n.系統
시아버지=n.公公
시야=n.視野；視線。
시어머니=n.婆婆
시외=n.市外
시외버스=公路局車,巴士服務
시월=n.十月
시위=n.示威
시인=n.詩人
시일=n.時間,日期
시작=n.開始;開端;開頭;起頭
시작이반=n.萬事開頭難
시장=n.市場,市長
시절=n.時節
시점=n.起始點
시중=n.侍候,服侍
시즌=n.季節
시집=n.詩集
시청=n.市政府
시청률=n.收視率
시청자=n.觀眾
시합=n.比賽
시험=n.考試
식=n.方式
식구=n.家裡人
식기=n.食器
식당=n.食堂,餐廳
식량=n.糧食,食量
식료품=n.食品
식물=n.植物
식빵=n.麵包
식사=n.吃飯
식사비=n.伙食費
식사예절=n.韓國的飲食文化
식생활=n.飲食生活
식솔=n.家人,食率,家口,家眷
식욕=n.食欲
식용유=n.食用油
식초=n.醋
식탁=n.餐桌
식품=n.食品
식품점=n.食品店
신=n.鞋子
신경=n.神經,費腦筋
신경학자=n.神經學者
신고=n.申訴,報警
신규=n.新規定
신년=n.新年
신념=n.信念,信心
신라=n.新羅(古代的國家名稱)
신랑=n.新郎
신뢰=n.信賴
신망=n.信任
신문=n.報紙
신문사=n.報社
신문지=n.報紙
신발=n.鞋
신부=n.新娘
신분=n.身份
신비=n.神秘
신사=n.紳士
신설=n.新建設,新建
신세=n.不幸的身世,處境,遭遇,命
신세대=n.新一代,新世代
신용=n.信用
신용카드=n.信用卡
신인=n.(娛樂圈)新人
신입생=n.新生
신장=n.身長
신제품=n.新產品
신청=n.申請
신청서=n.申請
신체=n.身體
신체적=n.身體的,身體上
신호=n.信號
신호등=n.交通號誌
신혼부부=n.新婚夫婦
신혼여행=n.新婚旅行;蜜月旅行
신화=n.神話
실=n.棉線,麻線,絲線
실감=n.真實感
실내=n.室內
실력=n.實力
실례=n.失禮
실망=n.失望
실색=n.失色,因為驚訝或者恐懼臉色變化
실수=n.失誤
실습=n.實習
실시=n.實施,即時
실업률=n.失業率
실장=n.老闆,室主任,室長
실정=n.實情
실제=n.實際
실질적=n.實質性的
실천=n.實踐
실체=n.實體
실크로드=n.絲綢之路,silk road
실태=n.失態
실패=n.失敗,落敗,栽,翻船
실험=n.試驗,實驗
실현=n.實現
심리=n.心理
심리적=n.心理
심부름=n.跑腿
심사=n.心事
심장=n.心臟
심정=n.心情
심판=n.審判
십이월=n.十二月
십일월=n.十一月
십중팔구=n.十有八九
싸구려=n.便宜貨,賤賣
싹=n.芽,萌芽
싼값=n.賤價,廉價
쌀=n.大米
쌍=n.雙
쌍둥이=n.雙胞胎
쓰레기=n.垃圾
쓰레기통=n.垃圾筒
쓴맛=n.苦味;苦楚;苦頭
씨름=n.摔跤
씨앗=n.種子
아=唉,呀,啊哈
아가씨=n.小姐
아기=n.嬰兒,孩子
아나운서=n.廣播員
아내=n.妻子
아드님=n.兒子
아들=n.兒子
아래=n.下麵
아래쪽=n.下麵,下部,down
아래층=n.樓下
아랫사람=n.晚輩
아르바이트=n.兼職打工
아름다운추억=n.美麗的回憶
아무=n.什麼
아무개=n.某
아무것=n.什麼,什麼東西어떤 것
아무런=n.任何。和“없다、않다、못하다”等否定詞搭配使用。
아버님=n.爸爸
아버지=n.爸爸
아빠=n.爸爸
아쉬움=n.捨不得,遺憾,可惜아쉬워하는 마음.또는 그런 상태
아스팔트=n.柏油路
아시아=n.亞洲,亞洲大陸
아이=n.孩子
아이디어=n.思路,創意
아이스크림=n.霜淇淋
아저씨=n.大叔
아주머니=n.大媽
아줌마=n.阿姨
아침=n.早晨
아파트=n.小區,公寓
아프리카=n.非洲
아픔=n.疼痛;創傷
아홉=n.9
아흔=n.90
악기=n.樂器
악몽=n.惡夢
악수=n.傾盆大雨,滂沱大雨
악취=n.惡臭
안개=n.霧땅 위에 연기처럼 뿌옇게 낀 김
안경=n.眼鏡
안과=n.眼科
안날=n.前一天
안내=n.帶路,引導,嚮導,介紹,指南,服務,查詢,陪同
안동=n.安東(地名)
안방=n.內房
안부=n.平安與否
안색=臉色.氣色.臉色.臉上的表情
안전=n.安全
안전성=n.安全性
안정=n.安靜;靜養;平靜;穩定
안주=下酒菜.安歇.滿足現狀
안쪽=n.內側
안팎=n.內外,裡外
알=n.粒,蛋
알루미늄=n.鋁
알코올=n.酒精
암=n.雌的,母的
암시=n.暗示
암컷=n.母的,雌的,牝的
압력=n.壓力
앞=n.前
앞길=n.前途
앞날=n.未來
앞뒤=n.前後,先後
앞문=n.前門,大門
앞바다=n.近海
앞쪽=n.前方
앞치마=n.圍裙
애=n.心機
애견=n.愛犬
애니메이션=n.動畫animatiom
애인=n.戀人
애정=n.愛情
애지중지=n.疼愛有加,愛之重之
애초=n.當初
액세서리=n.飾品;首飾
액수=n.額數
액체=n.液體
앨범=n.相冊
야간=n.夜間,夜晚
야구=n.棒球
야구장=n.棒球場
야근=n.夜班퇴근 시간이 지나고 밤 늦게까지 직장에서 일을 함.
야단=n.喧嚷,奔忙,喧鬧
야외=n.野外
야유=n.揶揄；嘲笑；噓聲
야채=n.野菜
약=n.藥
약국=n.藥店
약속=n.約定,約會,諾言
약수=n.藥水;礦泉水
약재=n.藥材
약점=n.弱點
약품=n.藥品
약혼녀=n.未婚妻
약혼자=n.未婚夫
양=n.羊
양국=n.兩國
양념=n.調料
양력=n.陽曆
양말=n.襪子
양배추=n.洋白菜,捲心菜,包心菜
양보=n.謙讓
양복=n.西服
양분=n.養分
양상추=n.萵苣
양식=n.糧食
양심=n.良心
양옆=n.兩邊
양주=n.釀酒
양지=n.向光面
양쪽=n.兩邊
양파=n.洋蔥
얘=n.呀,唷(詞尾)
얘기=n.聊天,故事
어=n.啊,咳,咍
어깨=n.肩膀
어둠=n.暗
어떤=n.什麼樣的指人
어려움=n.困難；困苦。
어류=n.魚類
어른=n.成人;大人
어린아이=n.小孩兒
어린애=n.小孩
어린이=n.小孩,兒童
어린이날=n.兒童節
어머니=n.媽媽
어머님=n.媽媽
어부=n.漁夫
어저께=n.昨天
어제=n.昨天
어젯밤=n.昨夜,昨天晚上
어지럼증=n.眩暈症눈앞이 아찔하고 정신이 흐려지는 증세
억=n.億
억양=n.抑揚,(說話時的)抑揚頓挫말을 할 때 소리의 높낮이에 변화를 주는 일
언급된내용=n.提及的內容
언니=n.姐姐(女性稱呼女性)
언론=n.言論,傳媒；媒體
언론사=n.媒體,新聞單位
언어=n.語言
언젠가=n.有朝一日
얼굴=n.臉
얼굴색=n.臉色
얼룩=n.汙點
얼마=n.多少,若乾
얼음=n.冰
엄마=n.媽媽
업계=n.業界
업무=n.業務
업종=n.行業
업체=n.企業
엉덩이=n.屁股
엉망=n.亂糟糟,亂套。亂七八糟。一塌糊塗。亂成一鍋粥
엉터리=n.荒誕,荒唐
엊그저께=n.前兩天,幾天前
엊그제=n.昨天和前天
에너지=n.能量
에너지원=n.能源
에어컨=n.空調
에어컨필터=n.空調過濾器
에의=n.禮儀
엔진=n.引擎,發動機
엘리베이터=n.電梯
여=n.女
여가=n.餘暇,空閒
여건=n.條件,與件
여고생=n.女高中生
여관=n.旅館
여군=n.女兵
여권=n.護照
여대생=n.女大學生
여덟=n.8
여동생=n.妹妹
여든=n.八十
여러=n.各種
여러분=n.各位
여럿=n.很多;不少;有一些;有幾個
여론=n.輿論
여름=n.夏天
여름용이불=n.夏季用被子
여름철=n.夏季
여보=n.喂(平輩之間稱呼)
여분=n.多餘,富餘額外的
여섯=n.6
여성=n.女性
여왕=n.女王
여우=n.狐狸
여유=n.做某事所需的時間或錢富裕,富足
여인=n.女人
여자=n.女子
여자친구=n.女朋友
여직원=n.女職員
여학생=n.女學生
여행=n.旅行
여행사=n.旅行社
역무원=n.站務員
역사=n.歷史
역사가=n.歷史學家
역사상=n.歷史上
역사적=n.歷史的
역사학=n.歷史學,史學
역전현상=n.逆轉現象
역증=n.生氣
역지사지=n.易地思之
역할=n.作用;割役
연간=n.年間
연결=n.連接
연계=n.聯繫
연관=n.關聯,關係,聯繫
연구=n.研究
연구소=n.研究所
연구실=n.研究室
연구원=n.研究院
연구자=n.研究者
연극=n.演劇,話劇
연극계=n.戲劇界
연기=n.演技
연기자=n.表演者
연두색=n.淡綠,淺綠
연락=n.聯絡
연락처=n.聯絡處
연령=n.年齡
연말=n.年末
연봉=n.年薪,年奉
연설=n.演說
연세=n.(敬)年齡나이的敬語
연속=n.adv.續
연쇄살인=n.連環殺人
연습=n.練習
연애=n.戀愛
연예인=n.藝人
연인=n.戀人
연장=n.工具,器具
연주=n.演奏
연초=n.煙草
연출=n.導演
연필=n.鉛筆
연합=n.聯合
연합회=n.聯合會
연휴=n.連休
열=n.10
열기=n.熱氣
열두=n.12
열람실=n.閱覽室
열매=n.果實
열성=n.熱誠,熱心,心血,積極
열셋=n.13
열쇠=n.鑰匙
열정=n.熱情
열차=n.列車
열흘=n.十天
염려=n.擔心,掛念
염퉁=n.心臟
엽서=n.明信片
영광=n.榮光,自豪,榮幸,光榮
영국=n.英國
영남=n.[지리] 嶺南。(鳥嶺以南，即慶尚南北道地區)
영문=n.理由
영상=n.零上
영양=n.營養
영어=n.英語
영업=n.營業,銷售
영업과=n.營業部
영역=n.領域
영웅=n.英雄
영하=n.零下
영향=n.影響
영향력=n.影響力
영혼=n.靈魂
영화=n.電影
영화관=n.電影院
영화배우=n.電影演員
영화제=n.電影節
옆=n.旁邊
옆구리=n.肋下
옆방=n.隔壁
옆집=n.鄰居
예감=n.預感
예금=n.訂金,預存款
예물=n.禮品
예방=n.預防
예보=n.預報
예비=n.預備
예산=n.預算
예상=n.預想
예선=n.預選,(體育比賽)預賽
예순=n.60
예술=n.藝術
예술가=n.藝術家
예술적=n.藝術(的)
예술적감각=n.藝術感覺
예습=n.預習
예식장=n.禮式場,婚宴廳。결혼식에 필요한 장소와 설비를 갖추어 놓은 곳.
예약=n.預約
예외=n.例外
예의=n.禮貌
예전=n.過去,從前
예절=n.禮儀
예정=n.預定,打算,計畫,豫定
옛=n.古老
옛날=n.很久以前
옛날이야기=n.昔日的故事
오=5,(china)
오늘=n.今天
오늘날=n.今天
오락=n.娛樂
오래간만=n.好久;很久之後；過了好久
오래전=n.很久以前
오랜=悠久的;古老的;以前的
오랜만=n.隔很長時間
오랫동안=n.好久
오렌지=n.柳橙
오른발=n.右腳
오른손=n.右手
오른쪽=n.右邊
오리=n.鴨子
오물=n.垃圾,汙穢,汙物더럽고 지저분한 물건
오븐=n.烤爐
오빠=n.哥哥(女稱男)
오십=50,(china)
오아시스=n.綠洲,oasis
오염=n.污染
오월=n.五月
오이=n.黃瓜
오전=n.上午
오존층=n.臭氧層
오징어=n.魷魚
오페라=n.歌劇
오피스텔=n.商住兩用房
오해=n.誤會
오후=n.下午
옥=n.玉
옥상=n.屋頂,屋頂平臺
옥수수=n.玉米
온=n.所有
온갖=n.各種,一切,所有的
온도=n.溫度
온돌=n.炕
온라인=n.網路,連線,上網
온라인게임=n.網路遊戲,online game
온몸=n.全身
온종일=n.整天,整日
올=n.線條兒,股,今年
올가을=n.今秋,今年秋天
올겨울=n.今年冬天
올림픽=n.奧林匹克
올림픽경기장=n.奧運會競技場
올여름=n.今年夏天
올해=n.今年
옷=n.衣服
옷차림=n.衣著,穿著,穿戴
와=n.和,同,與
와아들=n.獨生子
와이셔츠=n.襯衫
와인=n.酒紅
완성=n.完成
완전=n.完全,完整,完美,全
왕=n.王
왕비=n.王妃
왕자=n.王子
외=n.獨
외가=n.婆家
외갓집=n.外婆家
외과=n.外科
외교=n.外交
외교관=n.外交官
외국=n.外國
외국어=n.外國語
외국인=n.外國人
외로움=n.孤獨(名詞型)
외모=n.外貌
외부=n.外部,外界
외삼촌=n.舅舅
외손자=n.外孫
외식=n.下館子
외아들=n.獨生子
외유내강=n.外柔內剛
외제=n.外國制,外國造；外國產,外製
외출=n.外出
외침=n.呐喊,叫喊
외피=n.外皮
외할머니=n.外婆
외할아버지=n.外公
왼발=n.左腳
왼쪽=左
요가=n.瑜珈,yoga
요구=n.要求
요금=n.費用
요리=n.料理
요리사=n.廚師
요사이=n.最近
요새=n.要塞
요일=n.星期
요즈음=n.近來,這兩天
요청=n.要求,請求,邀請
욕=n.苦頭;責備
욕망=n.貪心
욕실=n.浴室
욕심=n.欲望,貪欲
용=n.龍
용기=n.勇氣;容器
용도=用途
용돈=n.零花錢
용모=n.容貌;外貌
용서=n.寬恕,饒恕
용어=n.用語
용의꼬리=n.龍的尾巴
우려=n.憂慮
우리=n.我們
우리나라=n.我國,我們國家
우리말=n.韓語,Korean
우산=n.雨傘
우승=n.取勝,冠軍
우승자=n.優勝者
우애=n.友愛
우여곡절=n.迂餘曲折,表示錯綜複雜的事情
우연적=n.偶然的
우울증=n.憂鬱症
우유=n.牛奶
우점=n.優點
우정=n.友情
우주=n.宇宙
우주선=n.飛船
우체국=n.郵局
우편=n.郵政
우표=n.郵票
우표수집=n.集郵
우후죽순=n.雨後春筍
운=n.運氣
운동=n.運動
운동복=n.運動服
운동장=n.運動場
운동화=n.運動鞋
운명=n.命運
운반=n.搬運,運送,運搬
운전=n.駕駛
운전기사=n.司機
운전면허증=n.駕駛證,駕照
운전사=n.司機
운전자=n.開車的人
운행=n.運行
울음=n.哭泣
울음소리=n.哭聲
울타리=n.柵欄
움직임=n.行動;動作
웃어른=n.長輩
웃음=n.笑,笑聲
웃음소리=n.笑聲
원=n.希望;圓
원고=n.原稿
원고지=n.稿紙
원래=n.原來,本來
원서=n.原件,申請表
원숭이=n.猴子
원유값=n.原油價格
원인=n.原因
원장=n.院長
원피스=n.衣裙
월=n.月
월급=n.月薪
월드컵=n.世界盃
월래=n.原來,本來
월력=n.月曆
월료일=n.星期一
월세=n.按月付款
월요일=n.星期一
월평균임금=n.月平均工資
웨이터=n.侍者,服務員(飯店)
웬=n.哪來的,幹什麼的
웬일=n.怎麼回事,有什麼事。以“웬일로”的形式，和“이다”搭配使用
위=n.上面
위기=n.危機
위로=n.慰勞
위반=n.違反
위법=n.違法
위성=n.衛星
위아래=n.地位或位子上下,高低
위원=n.委員
위원장=n.委員長
위주=n.為主
위쪽=上面,頂,上部,top
위층=n.樓上
위치=n.位置
위험=n.危險
위험성=n.危險
위협=n.威脅
위화감=n.抵觸情緒
윗몸=n.上體,上身
윗사람=n.上級;長者;大人
유교=n.儒教
유구한역사=n.悠久的歷史
유람=n.遊覽,瀏覽
유람객=n.遊客
유럽=n.歐洲
유료=n.收費
유리=n.玻璃
유리창=n.玻璃窗
유망분야=n.有希望的領域
유머=n.幽默
유명=n.有名,知名,著名,聞名
유명한일화=n.著名的逸事
유물=n.遺物
유산=n.遺產
유실물센터=n.遺失物中心
유아용품=n.嬰兒用品
유원지=n.遊樂園
유월=n.六月
유유자적=n.悠閒自在
유적=n.遺跡.遺址,유지
유적지=n.遺址
유전공학=n.遺傳(工)學
유전인자=n.遺傳因數
유치원=n.幼稚園
유태인=n.猶太人
유통업=n.流通業
유학=n.留學
유학생=n.留學生
유행=n.流行,時尚
유형=n.類型
육군=n.陸軍
육체=n.肉體,身體
육체적=n.肉體的,身體的
윤리=n.倫理
은=n.銀
은행=n.銀行
은행대출=n.銀行貸款
음=n.音
음란물=n.淫亂物
음력=n.陰歷
음료=n.飲料
음료수=n.飲料
음반=n.唱片
음성=n.聲音(說話),噪音,사람의 발음 기관에서 나오는 구체적이고 물리적인 소리
음식=n.食物
음식물=n.食物
음식점=n.餐館
음악=n.音樂
음악가=n.音樂家
음악회=n.音樂會
음주=n.飲酒
응=n.是,yes (非敬語)
의견=n.意見
의구심=n.疑慮心,疑懼感
의논=n.議論
의도=n.意圖
의도적=n.有目的地,神秘化
의류=n.衣類,服裝類
의무=n.義務
의문=n.疑問
의미=n.含義,意味
의복=n.衣服
의사=n.醫生
의사소통=n.相互溝通,意思交流
의식=n.儀式,意識
의식하다=n.意識,儀式
의심=n.疑心
의욕=n.意欲,意志
의원=n.議員
의의=n.意義
의자=n.椅子
의지=n.意志
의학=n.醫學
의학계=n.醫學界
의흑=n.疑心
이=2,(china)
이거=n.這,어것的略語
이것=pron.這個
이것저것=n.這個那個
이곳=n.這裡
이곳저곳=n.到處
이공계=n.理工科이겅과
이날=n.以那
이내=以內
이념=n.理念
이놈=好小子
이달=n.本月
이데올로기=n.意識形態
이동=n.移動
이때=n.這時,此時,現在
이래=n.以來
이래서=n.以來
이런=int.噯呀(感到意外時)
이런저런=n.這樣那樣的
이력서=n.履歷表
이론=n.理論
이론적=n.理論的,理論性的
이름=n.姓名
이리=n.這裡
이마=額頭
이메일=n.電子郵件,E-mail
이모=n.姨媽
이미=n.已經
이미지=n.圖片,印象,image
이민=n.移民
이발사=n.理髮師
이발소=n.理髮店
이번=n.這次
이별=n.離別,別離,分手,分袂
이분=這位
이불=n.被子
이빨=n.牙齒
이사=n.搬家
이사장=n.董事長,社長
이삭=n.穗子
이삿짐=n.搬家時的行李
이상=n.以上;前面說的內容
이상적=n.理想的,合乎理想的
이성=n.理性
이슬=n.露水
이심전심=n.心照不宣,心心相印
이야기=n.故事
이외=n.以外,除此之外
이용=n.利用
이용자=n.用戶
이웃=n.鄰居
이웃집=n.鄰居
이월=n.二月
이유=n.理由;原因
이익=n.利益,好處
이자=n.利息
이전=n.以前
이제야=n.現在,目前
이중=n.二重,雙重
이집트=n.埃及,Egypt
이쪽=n.這邊
이타심=n.利他心
이튿날=n.第二天
이틀=n.兩天,初二
이파리=n.葉子
이하=n.以下
이해=n.理解,領悟
이해관계=n.利害關係
이혼=n.離婚
이후=n.以後
인=n.癮,仁,磷
인간=n.人間,人類
인간관계=n.人際關係
인간성=n.人性
인간적=n.人的,人間的
인격=n.人格
인공=n.人工
인구=n.人口
인권=n.人權
인근=n.鄰近
인기=n.人氣
인도=n.人道
인류=n.人類
인류공영=n.人類共榮
인류학=n.人類學
인물=n.人物
인분=n.[C]每份食品
인사=n.問候
인사말=n.問候語,致辭,인사로 하는 말.
인삼=n.人蔘
인삼차=n.人參茶
인상=n.印象,(物價,工資等)上升
인상적=n.印象深刻
인생=n.人生
인생의허무함=n.人生的虛無感
인쇄=n.印刷
인연=n.姻緣
인원=n.人員
인재=n.人才
인제=n.現在
인종=n.忍從
인천=n.仁川(地名)
인천공항=n.仁川機場
인체=n.人體
인터넷=n.網際網路
인터뷰=n.面試
인하=n.降低(物價)
인형=n.洋娃娃,玩偶
일=n.事情
일거양득=n.一舉兩得
일곱=n.七
일기=n.日記
일기예보=n.天氣預報
일단=n.一端,一頭兒
일대=n.地區
일등=n.一等,第一名
일반=n.一般
일반인=n.普通人
일반적=n.一般的
일방적=n.片面的
일본=n.日本
일본어=n.日本語
일부=n.一部份
일부분=n.一部份
일사천리=n.一瀉千里
일상=n.日常
일상생활=n.日常生活
일상적=n.日常,經常
일생=n.一生
일석이조=n.一石二鳥
일손=n.手
일시적=n.一時的
일식=n.日蝕
일쑤=n.總是,動不動,經常做的行為‘~기(가) 일쑤이다’ 구성으로 쓰여 흔히 또는 으레 그러는 일
일요일=星期日,日曜日,星期天,Sunday
일월=n.一月,正月
일자=n.日子
일자리=n.工作,崗位
일정=n.日程
일종=n.一種,某種하나의, 어떤
일주일=n.一周
일체=n.一切
일출과일몰=n.日出和日沒
일치=n.一致
일터=n.工作場所
일행=n.一道走
일화=n.奇聞.趣聞.軼事.逸話
일회용=n.一次性
일회용품=n.一次性用品
일흔=n.70
임금=n.工錢,群主(王)
임기응변=n.隨機應變
임무=n.任務
임시=n.臨時
임시정부=n.臨時政府
임신=n.妊娠
임신부=n.孕婦
임의=n.任意,隨意,隨便,自願,自由
입=n.口,嘴
입구=n.入口
입국=n.進入國境,入境
입대=n.入隊,入伍
입력=n.(電腦上的)輸入
입맛=n.胃口
입사=n.投射
입술=n.嘴唇
입시=n.口,嘴
입양=n.領養,認領
입원=n.住院
입장=n.立場
입학=n.入學
잎=n.葉子
자=n.尺
자가용=n.私用
자격=n.資格
자격증=n.資格證書
자극=n.刺激
자기=n.自己
자기계발=n.自我啟發
자네=n.你(第二人稱代詞), {敬}你。用於朋友或年紀比自己小的人。
자녀=n.子女
자동=n.自動
자동차=n.汽車
자랑=n.驕傲的事情
자료=n.資料
자리=n.座位,位置
자립=n.自立
자매=n.姊妹
자백=n.自白
자부심=n.豪感,自信心자신의 가치나 능력을 믿고 당당히 여기는 마음.
자살=n.自殺
자세=n.姿勢;姿態;狀態
자승자박=n.作繭自縛
자식=n.子息；兒女
자신=n.自己
자신감=n.自信感
자연=n.自然
자연적=n.然的
자연현상=n.自然現象
자연환경=n.自然環境
자원=n.資源
자유=n.自由
자유자재=n.自由自在
자율=n.自律
자장면=n.炸醬麵
자전거=n.自行車
자정=n.子夜
자제=n.克制,自持,自製
자존심=n.自尊心
자체=n.本身,自身
자취=n.痕跡;蹤跡;軌跡
자치=n.自治,自然治理
자태=n.姿態
자판=n.鍵盤
자판기=n.自動販賣機
작가=n.作家
작년=n.去年
작성=n.制訂,擬訂(事件,報告)等
작업=n.勞動,工作;作業
작오=n.覺悟
작용=n.作用
작은딸=n.小女兒
작은아들=n.小兒子
작은아버지=n.叔叔
작은어머니=n.嬸母
작품=n.作品
잔=n.[C]玻璃
잔디=n.短草,矮草
잔디밭=n.草坪
잔여=n.殘餘
잔치=n.宴席,酒席,宴會
잘못=n.過錯,錯誤
잘못하다=做錯
잘잘못=n.是非
잠=n.覺(sleep),睡意
잠깐=n.稍微오래지 않은 짧은 동안
잠바=n.夾克
잠수함=n.潛水艇
잠옷=n.睡衣
잠자리=n.睡床,睡覺的地方
잡지=n.雜誌
잡지사=n.雜誌社
장=n.[C]紙
장가=n.娶妻(男子結婚)
장갑=n.手套
장거리=n.長途
장관=n.壯觀
장군=n.將軍
장기간=n.長時間
장기적=n.長期的
장난=n.玩耍
장난감=n.玩具
장남=n.長男
장래=n.將來;未來;前途
장례=n.葬禮
장례식=n.葬禮
장르=n.體裁
장마=n.雨季
장마철=n.雨季,梅雨季節
장면=n.場面,場景,現場
장모=n.丈母娘,岳母
장모님=n.丈母娘,岳母
장미=n.薔薇
장비=n.喪葬費
장사=n.生意,買賣
장사꾼=n.商販,商人
장소=n.地點,場所
장수=n.長壽
장시간=n.長時間
장시일=n.長時間
장식=n.掩飾
장신구=n.裝飾品,首飾
장애=n.障礙
장애우=n.殘疾人,這是一個委婉的叫法
장애인=n.殘疾人
장인=n.匠人
장점=n.長處,優點
장차=n.將來,將次,將要,今後
장학금=n.獎學金
재간=n.才幹,能力
재능=n.才能
재료=n.資料,材料
재미=n.有趣
재산=n.財產
재생=n.重生,再生,復活
재수=n.運氣
재작년=n.前年
재정=n.財政
재주=n.才藝
재즈=n.爵士樂
재채기=n.噴嚏
재판=n.再版,審判,審理
재학=n.在校
재활용=n.再利用,迴圈利用
재활용품=n.可回收物品
저=n.鄙人
저거=n.那個
저것=n.那個
저고리=n.西服上衣.韓服的小卦,上衣。小襖。
저곳=n.那邊
저급=n.低級
저기=n.那
저녁=n.晚上
저녁때=n.晚上
저리=n.那邊.那裡
저번=n.那回,上一次
저울=n.秤
저자=n.作者,著者
저작권법=n.著作權法
저쪽=n.那邊
저축=n.儲蓄
저편=n.那邊
저희=n.我們
적=n.敵人
적극=n.積極
적극적=n.積極的
적성=n.赤誠,忠誠
적용=n.適用,應用
적응=n.適應
전개=n.開展
전경=n.前景
전공=n.(大學)專業
전구=n.電燈泡
전국=n.全國
전국적=n.全國的
전기=n.電
전기밥솥=n.電子鍋
전기요금청구서=n.電費通知單
전날=n.前一方
전달=n.傳達,傳話,轉達。轉交。傳遞
전라도=n.邊緣
전람회=n.展覽會
전망=n.前景;展望
전문=n.專門
전문가=n.專家
전문적=n.專門的
전문점=n.專門店
전문직=n.專業性職業
전반=n.整個,全體,全面
전반적=n.全般的,通盤的。整個的。全面的。
전선=n.電線
전설=n.傳說
전세=n.租房子
전시=n.展覽,展示
전시장=n.展示場
전시회=n.展覽會
전야제=n.前夜祭,前夜的祝典
전용=n.專用
전자=n.電子
전자사전=n.電子詞典
전자오락실=n.電子遊戲室
전쟁=n.戰爭
전철=n.轍
전체=n.全體;整個
전체적=n.全體的,整體的
전통=n.傳統
전통놀이=n.傳統(民間)遊戲
전통문화=n.傳統文化
전통적=n.傳統的
전화=n.電話
전화기=n.電話機
전화번호=n.電話號碼
전화위복=n.逢凶化吉
전환=n.轉換,變換
전후=n.前後
절=n.寺廟
절대적=n.絕對
절반=n.一半
절약=n.節約
절차=n.節次.步驟.順序.程式
젊은이=n.年輕人
젊음=n.年輕
점=n.點,占卜
점검=n.檢查,清點,點檢
점수=n.分數
점심=n.中午
점심때=n.中午時分
점심시간=n.午飯時間
점원=n.店員
점자=n.盲文,盲字。點字
접근=n.接近
접대=n.接待
접시=n.碟子,盤子
접촉=n.接觸,相撞,接尾
젓가락=n.筷子
정=n.鑿子
정거장=n.車站,停車場
정규학교=n.正規學校
정기=n.定期
정기적=n.定期的
정답=n.正確答案
정당=n.政黨
정도=n.程度,左右,約
정류장=n.車站
정리=n.整理；收拾
정말=n.真話;實話;真的
정면=n.正面
정모=n.岳母
정문=正門
정반대=n.完全相反
정보=n.資訊,情報
정보화=n.信息化
정부=n.政府
정비=n.正比
정상=n.頂峰
정상적=n.正常的
정성=n.精誠,真誠,誠心온갖 힘을 다하려는 진실되고 성실한 마음.
정식=n.正餐
정신=n.挺身。獻身
정신과=n.精神
정신적=n.精神的
정열=n.熱情,激情
정오=n.正午
정원=n.庭院
정장=n.正裝;制服
정전=n.停電
정종=n.正宗
정지=n.停止
정치=n.政治
정치권=n.政壇
정치인=n.政客
정치적=n.政治的,政治性的
정치학=n.政治學
젖=n.奶,乳
제공=n.提供
제과점=n.蛋糕店
제도=n.制度
제도적=n.制度
제목=n.題目
제비=n.燕子
제사=n.第四
제삿날=n.祭日
제시=n.出示,提出,提示
제안=n.提案
제약=n.製藥
제의=n.提議,建議
제자=n.弟子,學生
제자리=n.原位,原地
제작=製造
제조업=n.製造業
제주도=n.濟州島
제출=n.提出
제품=n.商品,產品,製品
제한=n.限制
조=兆,trillion
조각=n.片,塊
조각구름=n.斷雲,片雲
조감도=n.俯視圖
조개=n.貝,蚌
조개껍질=n.貝殼
조건=n.條件
조기=n.黃花魚,石首魚
조깅=n.慢跑
조력=n.潮力,海潮的動力
조명=n.照明
조미료=n.調味料
조사=n.調查
조상=n.祖先
조선=n.朝鮮
조식=n.朝時,早餐,早飯
조언=n.助言,有益的經驗
조절=n.調整,調節
조정=n.調停
조직=n.組織;團體
조카=n.侄子
족목=n.項目
존댓말=n.敬語,謙語
존재=n.存在
졸업=n.畢業
졸업생=n.畢業生
졸업식=n.畢業典禮
졸음=n.睏意,睡意
종=n.鐘
종교=n.宗教
종교재판=n.宗教裁判
종교적=n.宗教
종달새=n.雲雀
종로=n.鍾路
종류=n.種類
종소리=n.鐘聲
종아리=n.小腿肚子
종업원=n.從業員
종이=n.紙
종이비행기=n.紙飛機
종이컵=n.紙杯
종일=n.一整天
종합=n.綜合
좌담회=n.座談會
좌석=n.座位
좌우=n.左右
죄=n.罪
죄수=n.罪犯,囚犯。囚徒。
죄인=n.罪人,罪犯
주=n.周,一周
주거=n.居住
주관=n.主觀
주관적=n.主觀的
주년=n.周年
주름=n.皺折,皺紋
주름살=n.皺紋
주말=n.週末
주머니=n.口袋
주먹=n.拳頭
주문=n.訂閱,預訂
주민=n.住民
주방=n.廚房
주변=n.周邊
주변장치=n.周邊裝置,外部設備
주부=n.主婦
주사=n.注射;打針
주소=n.地址
주스=n.果汁
주식=n.股票,主食
주식투자=n.股票投資
주요=n.主要
주위=n.周圍
주유소=n.音{給油所} n.加油站
주의=n.主義
주의사항=n.注意事項
주인=n.主人
주인공=n.主人公
주일=n.週日;禮拜日
주장=n.主張
주전자=n.酒壺；茶壺；壺
주제=主題
주차=n.停車
주차장=n.停車場
주택=n.住宅
주한=n.駐韓
죽=n.粥
죽마고우=n.青梅竹馬
죽음=n.死。死亡。
준비=n.準備
준비물=n.準備好的東西
줄=隊,繩子
줄거리=n.情節소설, 이야기, 연극, 영화 따위에서 핵심이 되는 개략적인 내용
줄기=n.莖
줄무늬=n.線紋
중=n.和尚
중간=n.中途
중계방송=n.轉播
중고생=n.初高中生
중국=n.中國
중국어=n.中國話
중국집=n.中國餐廳
중년=n.中年
중단=n.中斷
중독=n.中毒
중부=n.中部
중세=n.中世紀
중소기업=n.中小企業
중순=n.中旬
중식=n.午餐,中飯
중심=n.中心
중심내용=n.中心內容
중심지=n.中心,中心地
중앙=n.中心.中央
중요=n.重要
중요성=n.重要性
중지=n.中止
중학교=n.中學
중학생=中學生
쥐죽은듯=n.比喻鴉雀無聲
즉석=n.即席,當場
즉시=n.adv.即時,立刻,立時,即刻,馬上,當場
즐거움=n.快樂
증가=n.增加
증거=n.証據
증권=n.證券,股票
증권사=n.證券公司
증상=n.症狀
증세=n.症狀
지=n.以後,之後
지각=n.遲到
지갑=n.錢包
지경=n.地步;境地
지구=n.地球
지구촌=n.地球村
지급=n.支付,發給
지난날=n.過去
지난달=n.上個月
지난번=n.上一次
지난주=n.上星期
지난해=n.去年
지능=n.智能,智商
지대=n.地區
지도=n.地圖
지도자=n.領導人
지동설=n.地動說
지렛대=n.杠杆,指為達到某種目的而進行的手段和力量。
지름길=n.捷徑
지리산=n.智異山
지방=n.脂肪
지붕=n.屋頂
지상=n.地上
지성인=n.知性人,知識份子。높은 지식과 지능을 갖춘 사람.
지속적=n.持續
지시=n.指示
지식=n.知識
지식인=n.知識份子
지역=n.地域
지열=n.地熱
지옥=n.地獄;(opp.천당),煉獄
지우개=n.擦子,橡皮
지원=n.支持,協助
지위=n.地位,位子
지적=n.(錯誤、缺點等)指摘；指責。
지점=n.分店;支店
지지=n.支持
지진=n.地震
지출=n.支出
지폐=n.紙幣
지표=n.指標,方向,目標,標準
지하도=n.地下道
지하철=n.地鐵
지혜=n.智慧
직불카드=n.借記卡
직선=n.直線
직업=n.職業
직원=n.職員
직장=n.職場,單位
직장인=n.上班族
직전=n.就要…的時候,即將…之前,前夕
직접적=n.直接的
직후=n.剛…以後
진격=n.進擊
진급=n.升級,升班
진단=n.診斷
진달래=n.杜鵑
진담=n.真話
진동=n.振動
진로=n.出路,前途
진료=n.診療
진리=n.真理
진보적=n.進步的
진실=n.真實,真的, 真相
진실로=n.真實,誠實
진심=n.真心
진열대=n.陳列台
진정=n.真情,衷心,真心
진지=n.飯,밥的敬語
진짜=n.真的;adv.真正地
진찰=n.診察
진출=n.登上,活動,活躍
진통=n.陣痛
진행=n.進行
진행자=n.主持人
질=n.質量
질문=n.提問,質問
질병=n.疾病
질서=n.秩序
질적=n.質的,品質的
질환=n.疾患,疾病
짐=n.行李
짐작=n.斟酌,酌量
집=n.家
집단=n.集團,團體
집단적=n.集體的
집안=n.家中,家內,家裡
집안일=n.家務事
집중=n.集中
집중적=n.集中的
집중호우=n.集中的暴雨
짓=n.行動;行為;小孩或動物等行為動作
짜증=n.發牢騷,不高興
짝=n.伴,雙,對
쪽=n.碎片兒
찌개=n.燉湯菜,火鍋
찌꺼기=n.渣滓
차=n.車,茶
차남=n.次子
차량=n.車輛
차레=n.順序
차례=n.祭祀.(節日或祖先生日等舉行的簡單的)茶禮
차림=n.穿戴,裝束,擺設,穿著
차림표=n.菜單,食譜,價目表。
차밭=n.種茶的田,茶+田
차별=n.差別
차선=n.車道線,次的
차이=n.差距
차이점=n.差異
차창=n.車窗
착각=n.錯覺
찬물=n.涼水
찬성=n.贊成
참가=n.參加
참기름=n.香油
참말=n.真話,實話
참새=n.麻雀
참석=n.出席,參加
참석자=n.出席者,參加者
참여=n.參與,參加
참외=n.甜瓜
참조=n.參照
찻잔=n.茶杯
창=n.窗,唱,槍
창가=n.窗口
창고=n.倉庫
창구=n.窗口
창문=n.窗戶
창밖=n.窗外
창의적활동=n.創意活動
창조=n.創造
창조적=n.創造的,創造性的
채널=n.頻道
채소=n.蔬菜
채용=n.人選拔;人選用;採用;聘用
채점=n.打分數,判卷
책=n.書
책가방=n.書包
책방=n.書店
책상=n.書桌
책임=n.責任
책임감=n.責任感
책임자=n.負責人
챔피언=n.冠軍;種子選手
처리=n.處理
처벌=n.處罰
처소=n.住所;住處;場所
처지=n.處境,境地
척=n.尺
천=num.千(數量詞)
천국=n.天國,也就是天堂
천둥=n.雷霆,指雷電交加的天文現象
천문관측=n.天文觀測
천문학자=n.天文學家
천장=n.天棚;天花板
천재=n.天才
천주교=n.天主教
천체망원경=n.天體望遠鏡
철=n.季節
철도=n.鐵道,鐵路
철학=n.哲學
철학자=n.哲學家
철학적=n.哲學的
첨부파일=n.附件,附加檔
첫날=n.第一天
첫째=n.第一
청국장=n.清曲醬湯
청년=n.青年,子弟
청년실업가=n.青年實業家
청바지=n.牛仔褲
청소=n.打掃
청소기=n.清潔器,吸塵器
청소년=n.青少年
청천벽력=n.晴天霹靂
청춘=n.青春
체계=n.體系
체계적=n.系統的
체계적인=n.系統性的
체온=n.體溫
체육=n.體育
체육관=n.體育館
체제=n.體制
체조=n.體操
체중=n.體重
체험=n.體驗
초=n.初
초기=n.初期
초대=n.招待,邀請
초대장=n.請帖,邀請函
초등학교=n.小學
초등학생=n.小學生
초록색=n.綠,草綠
초반=n.初期階段
초밥=n.壽司
초보=n.初步,初級
초보자=n.初學者,初步者어떤 일을 처음 시작하여 미숙한 단계에 있는 사람
초보적=n.初步的
초상화=n.肖像畫
초순=n.初旬,上旬
초여름=n.初夏
초원=n.草原
초저녁=n.傍晚,黃昏
초점=n.焦點
초청=n.邀請
초청장=n.聘書
초콜릿=n.巧克力
촛불=n.燭火
총=n.槍
총각=n.小夥子
총괄=n.總括
총리=n.總理
총장=n.總長,(大學)校長；(機構)總負責人
촬영=n.攝影
최고=n.最高
최고급=n.特級,頭號
최근=n.最近
최대=n.最大
최대한=n.最大限度
최대한도=n.最高限度
최상=n.最好
최선=n.最佳;盡力;竭盡全力
최소=n.最小
최소한=n.最小限度
최신=n.最新
최신기능=n.最新功能
최악=n.最壞
최저=n.最低
최저기온=n.最低氣溫
최종=n.最終
최종결정=n.最終決定
최초=n.最初
최후=n.最後
추가=n.追加,附加
추리소설=n.推理小說
추상적=n.抽象的
추석=n.秋夕,即中秋節
추억=n.回憶
추위=n.寒冷；冷
추진=n.推進
추천=n.推薦,介紹
추측=n.推測
축구=n.足球
축구공=n.足球
축구장=n.足球場
축소=n.縮小
축제=n.祝祭,慶典,慶祝儀式
축하=n.祝賀
춘천역=n.春川站,春川是一個地名
출구=n.出口
출국=n.出國
출근=n.上班
출발=n.出發
출발점=n.出發點
출산=n.分娩
출산율=n.(嬰兒)出產率,birth rate
출신=n.出身
출연=n.演出
출입=n.出入
출입국=n.出入境
출입문=n.出入的門
출장=n.出差
출퇴근=n.上下班
출판=n.出版
출판사=n.出版社
충격=n.衝擊
충격적=n.令人震驚
충고=n.忠告,勸告
충돌=n.衝突
충동=n.刺激
충분한=n.充分的
충전기=n.充電器
충치=n.蟲牙,蛀牙；齲齒。
취미=n.愛好,興趣
취소=n.取消
취업=n.就職
취재=n.取材
취직=n.就業
취향=n.志趣,情趣
층=n.層
치과=n.牙科
치료=n.治療
치료법=n.治療法
치마=n.裙子
치아=n.牙齒
치약=n.牙膏
치즈=n.乾酪,乳酪
친구=n.朋友
친속=n.親戚
친절=n.親切
친정=n.娘家
친족=親族.親屬
친척=n.親戚
칠=n.七
칠십=n.七十
칠월=n.七月
칠판=n.黑板
침=n.唾沫,唾液,口水
침대=n.床
침묵=n.沈默
침실=n.寢室
칫솔=n.牙刷
칭찬=n.稱讚,讚揚
카드=n.卡片
카레=n.咖哩
카메라=n.照相機,攝影機
카운터=n.櫃台
카페=n.咖啡館
칸=n.格,間
칼=n.刀子
칼국수=n.刀銷麵
캐나다=n.加拿大
캐릭터=n.角色
캠페인=n.比賽,戰役
커튼=n.窗簾,簾布
커피=n.咖啡
컨디션=n.身體的健康狀況
컬러=n.彩色
컴퓨터=n.電腦
컴퓨터게임=n.電腦遊戲,computer game
컵=n.杯子,cup
케이블카=n.纜車경사가 급한 사면을 따라서 부설된 레일 위에 강철로 꼬아 만든 케이블을 감아올리는 기계로 차량을 운전하여 승객이나 화물을 운반하는 철도.또는 그 차량.등산이나 운반용으로 쓴다
케이크=n.蛋糕,cake
케첩=n.番茄醬catchup
코=n.鼻子
코끝=n.鼻尖
코끼리=n.大象
코너=n.角落
코드=n.軟線,電纜cord
코미디=n.戲劇
코스=n.路線
코스모스=n.大波斯菊(植)
코치=n.教練
코트=n.外套
코피=n.鼻血
콘서트=n.音樂會
콜라=n.可樂
콜플렉스=n.[의학] 複雜的；情結(英語：complex)
콧물=n.鼻涕
콩=n.黃豆
콩나물=n.豆芽菜
쾌감=n.快感
쿠폰=n.抽獎券coupon
크기=n.大小
크리스마스=n.耶誕節,Christmas
크림=n.奶油
큰길=n.大路,公路,馬路
큰딸=n.大女兒
큰소리=n.大聲說話
큰아들=n.大兒子
큰아버지=n.伯父
큰어머니=n.伯母
큰일=n.大事
큰절=n.大禮；磕頭跪拜,禮
클래식=n.古典音樂;經典著作
클럽=n.俱樂部
키=n.身高,鑰匙(key)
키스=n.接吻,親嘴
킬로=n.千卡(路裡),大卡
킬로그램=n.公斤
킬로미터=n.公里
타국=n.它國,別國,外國
타당성=n.合理性,妥當性
타락=n.墜落
타입=n.澆灌
타자기=n.打字機
타향=n.他鄉
탁구=n.乒乓球
탁상공론=n.紙上談兵
탁자=n.桌子
탄생=n.誕生
탄소동화작용=n.碳化作用
탈출구=n.安全出口
탐욕=n.貪欲.貪婪.욕심
탑=n.塔
탓=n.原因(反面現象)
태도=n.態度
태아=n.胎兒
태양=n.太陽
태양계=n.太陽系
태양에너지=n.太陽能
태풍=n.颱風
택배=n.宅配,快遞,配送,送貨,
택시=n.計程車
탤런트=n.影視明星,大腕
터=n.地基
터널=n.隧道,隧洞
터미널=n.始發站
털=n.毛
테니스=n.網球
테러=n.恐怖
테스트=n.測試
테이블=n.桌子
테이프=n.帶子,彩帶,tape
텍스트=n.原典,原文,text
텔레비전=n.電視
토끼=n.免子
토대=n.根基,地基,基礎,土臺
토론=n.討論
토론자=n.發言者
토론회=n.討論會
토마토=n.蕃茄
토양=n.土壤
토요일=星期六,土曜日,Saturday
토의=n.討論
토지=n.土地
통=n.根本,完全地,只能用於口語
통계=n.統計
통과=n.通過
통념=n.常理,普通觀念。일반 사회에 널리 퍼져 있는 생각.
통로=n.通路
통신=n.通信
통역=n.翻譯(指口譯)
통역관=n.翻譯官
통일=n.統一
통장=n.存摺
통제=n.控制,統一管理,統制
통증=n.疼痛
통합=n.合併
통화=n.通話
통화요금=n.電話費,通話費
퇴근=n.下班
퇴로=n.退路
퇴원=n.出院
퇴직금=n.退職金,一次付清的退休金
투시도=n.透視圖
투자=n.投資
투표=n.投票
튀김=n.油炸食物
트럭=n.貨車；卡車
특권층=n.特權(階)層
특급=n.特級
특별=n.特別；特殊。用於一些名詞前，作定語。
특성=n.特點,特性
특수=n.特殊
특수성=n.特殊性
특정인=n.特定人
특징=n.特徵
특허법=n.專利法
틀=n.模型,框
틈=n.縫隙
티=n.灰塵
티눈=n.雞眼,肉刺
티브이=電視,TV
티셔츠=n.T恤
팀=n.團隊
파=n.蔥
파도=n.海浪,波濤
파란색=n.藍色
파리=n.巴黎
파업=n.罷業,罷工노동자들이 정부나 경영주에게 자기의 요구를 제기하고 그것을 관철하기 위해 일제히 작업을 중지하는 것
파일=n.文件,檔案,file,文件夾
파출소=n.辦事處
파티=n.聚會(party)
판=n.局面,場面
판결=n.判決
판단=n.判斷
판매=n.銷售,販賣,經銷
판사=n.審判員
판소리=n.板索裏,韓國傳統的說唱藝術,通常是一個藝人跟著鼓手的節奏清唱,內容多為敍述性質的.
팔=n.胳膊,八(數字)
팔년전=八年前
팔도=n.(朝鮮半島的)八道,在朝鮮和韓國指全國
팔순=n.八旬,八十歲
팔십=n.八十
팔월=n.八月
팝송=n.大眾歌曲
패션=n.潮流,時尚
팩스=n.傳真
팩시밀리=n.傳真
팬티=n.小衣,女用內褲
페인트=n.顏色,顏料
편=n.糕餅
편견=n.偏見
편의=n.舒服,方便
편의점=n.便利店,便利商店
편지=n.信件
평=n.評,評論
평가=n.評價
평균=n.平均
평상시=n.平時
평생=n.一生,平生
평소=n.平時；平常,平素
평양=n.平壤
평일=n.平日
평화=n.和平,平和
평화통일정책=n.和平統一政策
폐지=n.廢止
포도=n.葡萄
포도주=n.葡萄酒
포스터=n.宣傳畫,招貼畫
포인트=n.效果
포장=n.包裝
포장마차=n.路邊攤
포크=n.叉子,餐叉
포함=n.包含
폭=n.寬度
폭력=n.暴力
폭소=n.大笑
표=n.票,各種票據
표면=n.表面
표본=n.標本
표시=n.表示
표정=n.表情。神情。神色。
표제=n.標題
표준=n.標準
표준어=n.標準語
표현=n.表現
풀=n.草초본 식물을 통틀어 이르는 말
품=n.胸圍
품목=n.貨物
품질=n.品質
풍경=n.風景,景致
풍력=n.風力
풍속=n.風俗
풍습=n.風俗
풍자=n.諷刺;批判;不滿
프랑스=n.法國
프랑스어=n.法語
프로그램=n.電腦程式
프로젝트=n.項目project.
플라스틱=n.塑膠
피=n.血
피곤=n.疲勞,疲倦
피동적=n.被動的
피디=n.報紙文章
피로=n.疲勞
피망=n.青椒
피부=n.皮膚
피부암=n.皮膚癌
피시=n.PC,個人電腦
피아노연주=n.鋼琴演奏
피아니스트=n.鋼琴家,pianist
피자=n.匹薩
피해=n.被害,損害
피해자=n.被害者
필름=n.膠卷
필수=n.必要,必須
필수적=n.必須的,必要的
필연적=n.必然的
필요=n.必要
필요성=n.必要性
필자=n.筆者
필통=n.筆筒,筆盒
핑계=n.藉口,理由
하나=n.1
하나님=n.上帝
하느님=n.[종교] 上帝。天主。
하늘=n.天空
하드웨어=n.硬體
하루=n.一天
하룻밤=n.一夜
하반기=n.下半期
하숙집=n.租房(租賃的房子),寄宿房。指有償提供食宿的居民房。
하순=n.下旬
하얀색=n.白色的
하천=n.河川
하품=n.哈欠
학과=n.專業
학교=n.學校
학교생활=校園生活
학급=n.學級
학기=學期
학년=學年
학력=n.學力
학문=n.學問
학번=學號
학부모=n.家長
학비=n.學費
학생=n.學生
학생증=學生證
학생회=n.學生會
학생회장=n.學生會會長,學生會主席
학술=n.學術
학습=n.學習
학용품=n.學習用品,文具,學用品
학원=n.補習班
학위=n.學位
학자=n.學者
학점=n.學分
한=n.一;大概
한가운데=n.正中,中間,當中
한강=n.漢江(韓國)
한강대교=n.漢江大橋
한겨울=n.嚴冬
한계=n.限度；限制；界限
한구석=n.角落
한국=n.韓國
한국말=n.韓國話
한국어=n.韓語
한국여행=n.韓國旅行
한국의음식문화=n.選擇
한국적=n.韓國的
한글=n.韓國字
한글날=n.韓文節
한낮=n.正午,中午
한눈=n.一眼,一看
한데=n.一個地方,一起;某一處
한두=n.一兩個
한둘=n.一二
한때=n.一時
한라산=n.韓拿山(也叫漢孥山),在濟州島中部
한마디=n.一句
한문=n.漢文
한반도=n.韓半島
한밤중=n.深夜
한번=n.一次
한복=n.韓服
한순간=n.一轉眼,一展眼,刹那之間
한숨=n.一口氣
한식=n.韓國料理
한식집=n.韓餐館
한여름=n.仲夏,盛夏
한자=n.漢字
한자어=n.漢字
한잔=n.一杯
한쪽=n.一邊
한참=n.較長的時間(一般指幾十分鐘)
한창=n.正是,正式時候
한편=n.一邊
한평생=n.平生
할머니=n.奶奶
할아버지=n.爺爺
할어버지=n.爺爺
할인=n.折扣
합리적=n.理的
합법=n.合法
항공=n.航空
항공기=n.飛行器
항구=n.港口
항암효과=n.抗癌效果
항의=n.抗議
해=n.年
해결=n.解決
해군=n.海軍
해답=n.解答
해당=n.有關,相關
해마다=n.每年
해명=n.解釋
해물=n.海鮮
해석=n.解釋
해설=n.解說,解說,說明,講解
해소=n.咳嗽
해수욕장=n.海水浴場
해안=n.海岸,海邊
해양동물=n.海洋動物
해열제=n.解熱劑
해외=n.海外
해외여행=n.出國旅行
해외영업부=n.海外營業部
핵심=n.核心
핸드백=n.手提包
햄=n.火腿
햄버거=n.漢堡
햇볕=n.陽光
햇빛=n.日光,陽光,光線
행동=n.行為,行動
행복=n.幸福
행사=n.活動,一般指公開的活動
행운=n.幸運
행위=n.行為,舉動
향=n.香
향기=n.香氣(꽃이나 향 따위에서 나는) 기분 좋은 냄새
향상=n.向上。提高。增強。進步
향수=n.香水
허가=n.許可
허락=n.許可,允許,答應
허리=n.腰
허용=n.容許
허위=n.虛偽
허허=n.呵呵
헌=舊,爛,破
헌법=n.憲法
헌혈=n.獻血
헬기=n.直升飛機
현관=n.家門口,入口
현관문=n.前門,入口
현금=n.現金
현대=n.現代
현대사=n.現代史
현대인=n.現代人
현대적=n.現代化的
현상=n.現象
현실=n.現實
현실성=n.現實性
현실적=n.現實的
현장=n.現場;當場
현재=n.現在
현정부=n.現(在的)政府
혈액=n.血液
혐오증=n.厭惡症
협조=n.協助；配合
형=n.哥哥
형님=n.哥哥
형부=n.姐夫
형사=n.刑事
형상=n.形象
형성=n.形成；達成。
형수=n.嫂嫂
형식=n.形式
형식적=n.式上,表面上
형제=n.兄弟姐妹
형태=n.形態,樣子,形式
형편=n.形便,情況;情形,境況,境地
혜택=n.會澤,恩澤,好處,恩惠,惠顧사회의 제도나 사업이 사람들에게 주는 이익과 도움
호=n.號
호기심=n.好奇心
호랑이=n.老虎
호령=n.喧斥,發號施令
호미=n.鋤頭1.김을 매는 농기구의 하나 2.끝이 뾰족하고 위는 넓적한 날이 ‘ㄱ’ 자로 꼬부라져 있으며 나무로 된 손잡이가 달려 있다
호박=n.南瓜
호선=n.地鐵線路
호수=n.湖
호실=n.室,房間
호응=n.呼應
호주=n.澳洲
호주머니=n.口袋
호텔=n.賓館
호흡=n.呼吸
호흡기질환=n.呼吸系統疾病
혹한=n.黑板
혼잣말=n.自言自語
홈페이지=n.個人主頁,homepage
홍두깨=n.棒槌,搗衣棒
홍보=n.宣傳,廣告
홍수=n.洪水
홍익인간=n.弘益人間
홍차=n.紅茶
홍콩=n.香港,Hong Kong
화=n.火
화가=n.畫家
화면=n.畫面
화물=n.貨物
화박반응=n.化學反應
화분=n.花盆
화살=n.箭팽팽하게 당겼다가 얼른 놓은 활시위의 힘으로 멀리 날아가는 가늘고 긴 뾰족한 막대
화요일=n.星期二
화자=n.話者;講述者;說話的人
화장=n.袖長
화장실=n.洗手間,廁所
화장지=n.(洗手間的)手紙
화장품=n.化妝品
화재=n.火災
화제=n.話題
화학=n.化學
확보=n.確保,切實保證
확신=n.確信,堅信
확인=n.確認；證實；察看확실히 인정하거나 알아봄.
확장=n.擴張,擴充,擴大
확정=n.確定
환갑=n.花甲
환경=n.環境
환경오염=n.環境污染
환기=n.喚起,換氣
환상적색채=n.幻想的色彩
환영=n.歡迎
환율=n.匯率
환자=n.患者
활기=n.活力
활동=n.活動
활용=n.活用,利用
황소=n.大黃牛
회=n.回,屆,次
회견=n.會見,會晤,會面
회관=n.會館
회복=n.恢復
회사=n.公司
회색=n.灰色
회신=n.回信
회억=n.回憶
회원=n.會員
회의=n.會議
회장=n.會長,會場
회전=n.旋轉
회화=n.繪畫
획기적인상품=n.劃時代的商品
횟수=n.次數,回合
횡단보도=n.過街橫道
횡설수설=n.胡說八道
효과=n.效果
효과적=n.有效的
효도=n.孝道
효율=n.效率
효율적=n.效率的
효자=n.孝子
후=n.以後
후기=n.勁兒
후문=n.後門
후반=n.半
후배=n.後輩
후보=n.候補
후식=n.甜點,飯後甜點；飯後茶點
후자=n.後者
후천적=n.後天的
후추=n.胡椒
후춧가루=n.胡椒麵,胡椒粉
후회=n.悔
휘파람=n.口哨
휴가=n.休假
휴게=n.休憩,休息
휴게소=n.休息室
휴대전화=n.手機
휴식=n.休息
휴일=n.休息日
휴지=n.廢紙;衛生紙
휴지통=n.紙簍
흉기=n.兇器
흐름=n.水流,潮流, 走向
흑백=n.黑白,是非
흑인=n.黑人
흔적=n.痕跡
흡연량=n.吸煙量
흥미=n.興趣
희곡=n.戲劇
희망=n.希望
희생=n.犧牲
흰색=n.白色
힘=n.力氣,力量
소요=n.騷擾,喧嘩,喧鬧,騷亂
덮어씌우다=n.덮어쓰다的使動型
꼭 필요한=n.必要的
의미가 명확한=n.[의학] 明確的，不容置疑的；清楚明白的，不含糊的(英語：unequivocal)
평화시=n.和平城市
제마=n.制麻。麻紡
구두덜구두덜=n.嘮叨。嘀咕
다소간=n.1.多少；或多或少；若干。
홀로백=n.腔背(裝訂)
갈수록 태산=n.越來越壞,比喻處境越發艱難
여수=n.地名:麗水
여수.1=n.1.女囚
여수.2=n.2.濾水,過濾水。淨水。
여수.3=n.3.旅愁。鄉愁。
술책=n.計謀。計策。花招。詭計。伎倆。
편이다=n.偏於
뾰족한=n.鋒利的
전부.1=n.1.全部어떤 대상을 이루는 낱낱을 모두 합친 것
방문턱=n.門檻
가루좀=n.蛀蟲
배.1=n.1.梨
베이징=n.北京,Beijing
채.1=n.1.著,和
리모콘=n.遙控,remocon좀 떨어진 곳에 있는 기기나 장치에 신호를 보내어 그것을 작동하게 하는 기구
당성=n.黨性
목다리=n.拐杖，假支다리를 다쳤거나 본래 다리를 잘 못 쓰는 사람이 걷거나 설 때에 겨드랑이에 대고 짚는 지팡이
아침.2=n.2.早餐
홉=n.啤酒花
모공축소=n.毛孔收縮
종목=n.項目
추장=n.酋長
장간막=n.腸間膜
아침.1=n.1.早餐
짐바=n.行李繩;行李帶
흡사=n.恰似;好像
와아들.1=n.1.獨苗
고치=n.蠶繭
누에고치=n.蠶繭
살가죽=n.肉皮
달구지=n.牛車
플루트=n.長笛
앵두=n.櫻桃
백스페이스 키=退格鍵,back key 
혹=n.瘤.腫瘤(몸 속에)생긴 불필요한 살덩이
스카프=頭巾
가발=假髮
볼트=n.螺絲
너트=n.螺絲帽
이부자리=被子.棉被
악당=n.惡棍.惡漢.惡徒.惡少악한 짓을 하는 사람 .또는 그 무리
옷고름=n.衣服的飄帶
고름=n.膿,濃水
고름.1=n.1.衣服飄帶
곁옷고름=韓式上衣或長袍的裡衣帶
겉저고리=外衣.罩衣.套衣저고리를 껴입을 때 맨 겉에 입는 저고리
놀이공원=遊樂園
분진=粉塵.奮進
쌍욕=n.髒話.臭罵
트로트=n.韓國演歌
발라드=n.抒情歌曲ballade
댄스가요=快歌
코미디 영화=n.喜劇片
멜로 영화=n.愛情片
액션 영화=n.動作片
공포 영화=n.恐怖片
낫=鐮刀
소다=n.蘇打
벌칙=處罰規定
외동딸=n.獨生女
혈액형=血型
염소젓=山羊奶
솜옷=n.棉衣
성과=成果
카리스마=n.神奇的魅力,魔力,氣質,超凡能力charisma
조국=祖國
감기약=n.感冒藥
합창부=合唱團
회의장=n.會場
복구=復原.恢復.復工.排除死機
수해=水災
감전=n.觸電.感電
벼룩시장=跳蚤市場
한글 맞춤법=韓文拼寫法
뱃길=航道,水路,旅程,旅途
긴병=久病,病了好久的時間
육지=n.陸地
뭍=陸地
거주=居住,居住地
연놀이=n.放風箏
정욕=情慾
낯=n.臉面,面子,體面,臉,面孔
예전 여자 친구=n.前女友
팝발라드=n.情歌
발라드오페라=n.民謠歌劇
밀반죽=n.和白麵
고름집=n.膿包
협의이혼=법률.協議離婚
손색=n.遜色
디저트=n.甜點,(餐後)水果。冷盤。 (dessert (영))
근육통=n肌肉痛
문짝=n.門扇
결근=n.缺席,缺勤
계책=n.計策,計
도회지=n.城市,都市,都會
권고 사직=n.被勸退;被推辭
기억용량=n.儲存量;儲存能力
목욕가운=n.浴袍;浴衣
목욕수건=n.浴巾
수화=n.手語;水火
에스컬레이터=n.手扶梯:escalator
스파이=n.間諜;密探;特務
수전노=n.守財奴
비행접시=n.飛碟
비행 소년=n.不良少年
비행계기=n.飛行儀表
근검절약=n.勤儉節約
말실수=n.失言
한번 실수는 병가의 상사=勝敗乃兵家常事
거듭제곱=n.數學乘方
돈세탁=n.洗錢
몰래카메라=n.偷拍相機;監視器
재떨이=n.煙灰缸
침식=n.寢食
참가자=n.參加者
마각=n.馬腳
잔칫집=n.辦喜事的人家
태초=n.太初。指天地的形成及宇宙的始初
은정=n.恩情
중망=n.眾望
공짜로=n.白得；不花錢
구좌=n.戶頭;帳戶
무단=n.強行
무단.1=n.1.無故;無端
비자=n.簽證,visa
몸조리=n.調養;補陽;保養
방세=n.房租남의 집 방을 얻어 쓰며 그 대가로 내는 돈
돋보기=n.老花眼鏡;放大鏡
티슈=n.紙巾;面紙;衛生紙
걸상=n.凳子;長凳
의사일정=n.議事日程
위조품=n.贗品;仿冒品
군침=n.口水,垂涎입안에 도는 침.
섶나무=n.柴;柴火
섶=n.衣襟
내기=n.打賭;賭輸贏
드럼=n.架子鼓；圓筒；油桶
동메달=n.銅質獎章。銅牌。略語:맹휴(盟休)
목화송=n.棉花
통조림=n.罐頭
병마개=n.瓶蓋;瓶塞
솔방울=n.松果
일급=n.一等
올방개=n.荸薺
올밤=n.早熟栗子
봄철=n.春季;春日
속된 말=n.庸俗的話
쌀가루=n.米粉
차림새=n.穿著;打扮;穿戴
데이트룩=n.約會裝扮
기력=n.氣力;精力;力氣
찜질방=n.桑拿浴室;洗浴中心
과정.1=n.1.過程
감정.1=n.1.憾情,成見;氣,怨氣,不愉快的情緒;看法
감정.2=n.2.鑑定,檢驗
품속=n.懷裡
살림.1=n.1.生活;經濟狀況
살림.2=n.2.傢俱,生活用品；日用品
새살림=n.新生活;成家過新日子
조짐=n.徵兆；跡象
특색=n.特色
집집마다=n.家家戶戶
시간밥=n.定時飯；定時用餐
제시간=n.正點
삼개월=n三個月
태극기=n.太極旗
지방마다=n.每個地方
주일.1=n.週;星期
원자재=n.原材料
석탄=n.煤；煤炭
아이템=n.item,項目
설계사=n.設計師
뚫어뻥=n.馬桶疏通器
시류=n.時髦;潮流;時宜;時興
유언=n.遺言;遺囑
이끗=n.利;營利;賺頭
상부=n.上邊；上頭；上級
상부.1=n.1.上部；上部分
행방=n.去向
기념비=n.紀念碑
폭도=n.暴徒
탈것=n.可乘坐之物;交通工具
노끈=n.細繩
매듭=n.結;扣子
매듭.1=n.1.癥結;疙瘩;難題
매듭.2=n.2.一段落
끝매듭=n.末節;末尾
외벌매듭=n.單結;單扣
나비매듭=n.蝴蝶結
대차매듭=n.圓盤結
도래매듭=n.雙結;死結
매화매듭=n.梅花結
방승매듭=n.方結
생쪽매듭=n.疙瘩結
장구매듭=n.雙十字扣
매듭 팔찌=n.編織手鍊
나비매듭리본=n.蝴蝶結
기일=n.忌日
이끼=n.苔蘚
먹거리=n.小吃
조수=n.鳥獸；禽獸
조수.1=n.1.潮水
조수.2=n.2.助手
옆길=n.大路旁的小路
옆길.1=n.1.跑題；離題；走調
활=n.弓；弓箭
환급요건=n.返還要件
자기희생=n.自我犧牲
희생정신=n.犧牲精神
감상.1=n.鑑賞；欣賞
감상.2=n.2.傷感
마구잡이=n.蠻幹;莽撞
해물파전=n.海鮮煎餅
몽골=n.蒙古
가래=n.分類;分成;分支
물자=n.物資
쓸모=n.用處
지배=n.支配;統治
음소거=n.靜音;消音
후대=n.後代;後世
창살=n.窗格子
자물쇠=n.鎖
타륜=n.舵輪;舵盤
마스크=n.口罩;臉盤;面具
윗자리=n.上座;上席;上位;高位
찬바람=n.冷風;寒風
정상.1=n.1.冠軍;最好그 이상 더 없는 최고의 상태
정상.2=n.2.首腦;國家的最高領導
정상.3=n.事態;情形;情況
정상.4=n.4.案情;情況
정상.5=n.5.正常
전망.1=n.1.眺望;望;願景;視野
가스통=n.氣罐;煤氣罐
얼굴팩=n.面膜
옆얼굴=n.側臉
전람=n.觀覽;展覽
엉덩방아=n.跌坐
상대.1=n.上一代;上古時代
상대.2=n.2.面對;對象;對方
땅바닥=n.地面;地皮;地上
풍문=n.風聞;傳聞
스탠드=n.檯燈;架子
식성=n.胃口,飲食習慣；口味
분간=n.減輕量刑
음식상=n.食桌;飯桌
한도=n.限度;止境
갈피.1=n.1.疊層物的裡;中間;裡頭
전체수=n.全體需.整熟食品。(烤或燉整雞、整魚等食品)
간직=n.手藏;保管
처지.1=n.1.相處的關係
처지.2=n.2.地位;身份
생물체=n.生物體
용의자=n.嫌疑人
꽃망울=n.花蕾
목청=n.聲帶;嗓音
노예=n.奴隸
사우나=n.桑拿
바탕.1=n.1.根基;基礎
바탕.2=n.2.本質
숨결=n.呼吸;氣息
운반차=n.運輸車;搬運車
글쪽지=n.紙條
단축키=n.快捷鍵
운전대=n.方向盤；操縱桿
이치=n.道理;法則;原理,理致
연장.1=n.1.延長
바탕.3=n.3.院子;席子;坐席
바탕.4=n.4.工作地點;崗位
속임수=n.騙術；騙人的伎倆
포장.1=n.1.褒獎;褒賞
포장.2=n.2.用柏油，水泥鋪路
커트=n.剪髮;短髮
커트.1=n.1.影片剪接
철판=n.鐵皮;鐵板
장어구이=n.烤鰻魚
이삿찜=n.搬家行李
들놀이=n.郊遊；野遊
시험채용=n.試用
일리=n.一理,一定的道理
오막살이=n.茅蘆；茅舍
교단=n.講臺；教團
공단=n.工團；工業園區
보건=n.保健
여부=n.與否
요령=n.要領；要點
요령.1=n.1.訣竅；竅門
보호구=n.保護區
도둑질=n.偷；盜竊；做賊
소달구지=n.牛車
지상.1=n.1.報紙上;雜誌上
지상.2=n.2.世上；指現實世界
지상.3=n.3.至上；最高;無尚
지상.4=n.4.風水;地脈;地型
온천=n.溫泉
민낯=n.原臉;沒有化妝的臉;素顏
정글=n.雨林
교수.1=n.講授;教
모양.1=n.1.像,好像
사정.1=n.1.情況;文章;說到
사성.2=n.2.懇求;求情;面子;情面
사정.3=n.3.私情;私人感情
진저리=n.寒戰;冷戰;寒噤
코.1=n.鼻涕
대우=n.待遇；報酬
전단지=n.傳單
나태=n.懶惰
신속=n.迅速,快速
정확=n.正確。準確
소재.1=n.1.原料;原材料
소재.2=n.2.話題;素材
정담=n.充滿感情的對談
앞뒤.1=n.1.前因後果
앞뒤.2=n.2.前言後語
무책=n·無策;沒有辦法
대결=n.較量；對決；決議勝負
경계.1=n.1.警戒, 警備, 戒備, 警惕
간격.1=n.1.時間的間隔
간격.2=n.2.隔膜;隔閡
지점.1=n.1.地點;地方
성질.1=n.1.性格
헝겊=n.布；碎布
본심=n.真心；內心；本意；內心深處
교환.1=n.1.總機；話務員
전염=n.傳染;沾染;學壞
뗏장=n.草皮
국자=n.杓
바닥.1=n.1.地面
진전=n.進展
출연.1=n.1.捐助;捐贈
한데.1=n.1.露天。露外。野地。外邊。
한데.2=n.2.別處。別的地方。
형편.1=n.1.生活情況
이상.1=n.1.用在表示數量、基準等詞的後面, 表示“以上”
이상.2=n.2.異常
이상.3=n.3.異常狀態;異常情況
가정.1=n.1.苛政;暴政
가정.2=n.2.家政;負責家務;家務
가정.3=n.3.臨時決定;假設
가운=n.睡袍
가운.1=n.1.(醫生護士的)白大褂。
가운.2=n.2.(作禮拜時神父牧師穿的)禮拜服。
가운.3=n.3.(畢業典禮上老師和大學生的)禮服。
가운.4=n.4.(律師等的)法服。
의지.1=n.1.假肢
빨대=n.吸管
출혈=n.出血;虧本;流血
가축=n.家畜
대상=n.對象
대상.1=n.1.課題;項目
사물.1=n.1.事物;東西
구성.1=n.1.結構예술 작품에서, 이야기를 엮어서 꾸미는 것
가옥=n.家屋;房屋
공적=n.功績
공적.1=n.1.公共的;國家的;社會相關的
공적.2=公敵;公賊
영감.1=n.1.老人;老頭
조직.1=n.1.組織, 生物體的單位
정직함=n.正直
착함=n.善良
인지=n.認知;認定
폐부=n.肺腑
찬장=n.碗廚；碗櫃
한치=n.一寸；絲毫；半點
정권=n.政權
왼새끼=n.反搓草繩
중매=n.中媒,仲媒,說親,做媒
상란=n.戰亂；天災人禍；喪亂
상란.1=n.1.上欄；上一欄
부엌살림=n.廚房活；廚房用具
신집살림=n.新居生活
신혼살림=n.新婚生活
안팎살림=n.裡外生計
단칸살림=n.住一間房
홀앗이살림=n.小家庭生活
홀앗이=n.一手操持家務
푸닥거리=n.驅邪
살림살이.1=n.傢俱
차례.1=n.1.次列,順序
차례.2=n.2.次序,倫次
차례.3=n.3.目錄
차례.4=n.次,回
가운데.1=n.1.(某一地點)上, 當中 , 中間
가운데.2=n.2.(某一範圍)中, 當中
가운데.3=n.3.(做某事的)過程中, 期間
나눗셈=n.除法
파마=n.染髮;燙頭permanent
자취.1=n.1.自己做飯吃
아랫사람.1=n.下級;手下;部下;底下的人
공갈빵=n.油條;油餅
공갈죄=n.恐嚇罪
박차=n.加緊;加快;快馬加鞭
박차.1=n.1.拍車;馬刺
차제=n.在此;借此機會
공중.1=n.1.空中
구실.1=n.當作的事；份內的事；應起的作用
구실.2=n.藉口；作用
담기=n.膽氣;膽量
바깥식구=n.家裡的男人
친정식구=n.娘家的人
야시장=n.夜市
앞장=n.前頭；前面；前列
딤섬=n.點心
설태=n.舌苔
열증=n.熱症
확산=n.理念、思想等傳播;擴散
시기.1=n.1.嫉妒；記恨,猜忌
시작.1=n.1.試作；試作品
시기.2=n.2.時機,機會
성금=n.捐款,誠金
조화.1=n.1.造花；假花；人造花
조화.2=n.2.雕花；陶瓷雕花
조화.3=n.3.調和；協調；和諧
조화.4=n.4.吊花
조화.5=n.5.神通；神差
공차=n.公差
공차.1=n.1.空車；免費車
정면.1=n.1.精棉;精紡棉
발.1=n.1.壞習慣;先例
양해=n.諒解
현악기=n.弦
갈래=n.分成的部分，分類、門類、分支
가락지=n.戒指
파랑색=n.藍色
장치=n.比喻規則；組織
장치.1=n.1.裝置；設備
기구.1=n.1.氣球
기구.2=n.2.祈求;祈禱
기구.3=n.3.機構;組織
기구.4=n.4.詩歌尤其是漢詩起句
이용.1=n.1.理髮理容
회계사=n.會計師
당도=n.糖度
당도.1=n.1.到達;面臨,當到
티켓=n.票卷
스페인어=n.西班牙語
밤사이=n.夜間;夜裡;一夜之間
마감=n.收尾
마감.1=n.1.結束
굴뚝=n.煙囪
영화.1=n.1.榮華
영화.2=n.2.英鎊
배역=n.背叛;叛逆
배역.1=n.2.角色;配役
사공=n.船家
경사=n.傾斜, 傾斜度, 斜坡, 坡度
경사.1=n.喜事;喜慶之事
경사.2=n.2.經書和史書
강철=n.鋼鐵
케이블=n.覽繩;索;鋼絲繩
케이블.1=n.1.電纜
사면=n.四面;四周
사면.1=n.1.斜面
경사.3=n.3.競射;射箭比賽
경사.4=n.4.警查
경사.5=n.5.傾瀉
경사.6=n.6.經絲;經線
기계.1=n.棋界
기계.2=n.2.奇計;妙計
도로.2=n.2.徒勞
전방=n.前方；前線
전방.1=n.1.店舖；商店
덧거름=n.追肥
반찬거리=n.做菜的原料
규격=n.規格
내치=n.內痔암치질(-痔疾)’의 이전 말
가닥.1=n.1.線.縷.股.根
샐러드=n.沙拉
스테이크=n.烤肉
찢어진 청=n.破洞牛仔褲
전형=n.法典；典型
전형.1=n.1.轉型
전형.2=n.2.考察選拔,銓衡
헛일=n.白做的事;白幹的事
주말여행=n.週末旅行
벌판=n.田野;原野
화창=n.歌劇或唱劇的說唱
공지=n.公知;公告
제외=n.除外;例外;除了……之外
제외원리=n.除外原理
아바타=n.化身；分身
침략=n.侵略
난로=n.暖爐
사양=n.飼養
사양.1=n.1.推辭。謙讓。推讓。推謝。謝絕
사양.2=n.2.詞讓,客氣
사양.3=n.3.斜陽;夕陽
사양.4=n.4.沒落,衰退
배제=n.配藥;配劑
널=n.木板;板子
널.1=n.1.跳板
널.2=n.2.棺材
회의.1=n.懷疑
문제.1=n.1.門弟子的略語
문제.2=n.問題;題目
어미=n.詞尾
기술.1=n.1.記述;敘述
사정.4=n.4.司正;糾正;平反
사정.5=n.查定;審定;核定;評定
오직.1=n.1.瀆職
중간.1=n.1.重刊.再版.重印
중간.2=n.2.中間
중간.3=n.3.某事進行中
중간고사=n.期中考試
중간시험=n.期中考試
시험공부=n.準備考試;備考;應付考試
짠지=n.鹹菜
이방=n.異邦;異國
이방.2=n.史房
이방.3=n.離方
그제=n.前天
간장.1=n.1.肝腸
간장.2=n.2.肝臟
스킨=n.護膚水
선풍=n.旋風;風潮;颱風;氣旋
포장.3=n.3.帳篷;布帳;布幔
마차=n.馬車
도통.1=n.1.都統;總共;共計
도통.2=n.2.通達;通曉
북소리=n.鼓聲
먹장구름=n.烏雲
우뢰=n.烏雷
우량=n.雨量
우량.1=n.優良
약사발=n.藥碗
별미=n.別味;美味;特別的味道;特別的風味
성화.1=n.1.星火
성화.2=n.2.上火
성화.4=n.4.惱人;糾纏
성화.5=n.緊著催
부리=n喙;嘴
부리.1=n.1.附利;有息
귀경=n.歸京；回京
핵전쟁=n.核戰爭
대고.1=n.1.大鼓
두려움=n.恐懼;畏懼
무서움=n.恐懼感;害怕
맹장.1=n.1.猛將;虎將
맹장.2=n.2.猛仗;重仗型
대회.1=n.1.大賽
여러 번=n.多次;多遍;無數次;好幾次
지정=n.指定
한과=n.漢果
윷놀리=n.翻板子遊戲,發音:윤:노리
단독주택=n.單獨住宅,別墅
등잔불=n.燈火
신설동=n.新設動
행사.1=n.1.行使;使用;活動
이무기=n.巨蟒
부속=n.附屬；附件；零件
관련 문서=n.附件
부속서류=n.附屬書類；附件
간수=n.保管;保存;收藏
간수.1=n.1.照料;照顧
간수.2=n.2.看守
간수.3=n.3.澗水;溪水
간수.4=n.4.滷水;鹽滷
입고=n.進貨
장기실업=n.長期失業
담장.1=n.1.淡妝
유지.1=n.1.油脂
유지.2=n.2.油紙
유지.3=n.乳脂;奶油
유지.4=n.4.有旨;傳紙
유지.5=n.5.遺址
유지.6=n.6.遺紙
외환위기=n.外匯危機
침체=n.停滯,沈滯
세종=n.稅種
민경=n.民警
충실=n.蟲室
충실.1=n.1.忠實;忠誠
성취동기=n.成就動機
지수.1=n.止水;死水
지수.2=n.2.地下水
바깥소문=n.外面的傳聞
구제=n.舊制;舊制度
구제.1=n.1.驅除;消滅
금융=n.金融
깊이.1=n.1.深度
깊이.2=n.穩重, 深沉, (人或事物的)深度, 份量
천지이다=n.特別多
기초.1=n.根基;底子;地基
송부=n.寄;發;送
활성화=n.活性化
된장국=n.味增湯
정렬=n.整隊；列隊,排列；排隊
경계.2=n.2.敬啟;舊時寫信時的開頭語
추천.1=n.1.鞦韆
어버이날=n.雙親節
카네이션=n.康乃馨carnation
내리실문=n.前進方向左側門下車
혈육=n.血肉相連
정상수익=n.正常收益；正常回報
송금=n.匯款,送金
노래반주기=n.點歌機
노래자랑=n.賽歌;賽歌會
돌림노래=n.輪唱
노래 한곡=一首歌兒
속력=n.速度;發音송녁
호언장담=n.豪言壯語;說大話
물품=n.物品
상해=n.上海;傷害
정형=n.情形,情況
정형.1=n.1.整型
정형.2=n.2.定型
정형.3=n.正刑,死刑
정형.4=n.4.困難處境
파키스탄=n.巴基斯坦
상봉=n.上峰;最高峰
이산가족=n.離散家族
속생각=n.心思,想法,心裡話
주장.1=n.1.主掌,主管,掌管
주장.2=n.2.主將
주장.3=n.3.刑具朱仗
겸비=n.謙卑
겸비.1=n.兼備,雙全
겸비선화증권=n.劃紅線提單
재덕=n.德才
힘꼴=n.힘的鄙稱
억지웃음=n.強作笑臉,裝笑,強顏歡笑
웃음바다=n.笑聲一遍,哄堂大笑
회사직인=n.法人印章
조각.1=n.1.雕刻,雕塑
조각.2=n.2.組閣
성금.1=n.1.效果,效力
성금.2=n.2.必行的命令
감전.1=n.1.敢戰
네티켓=n.上網禮節netiquette
여유.1=n.1.不慌忙,心胸廣闊
별로.1=n.1.離別的場合
동정.1=n.1.同情
의연금=n.捐款,義捐金
세일신간=n.促銷時間
매니큐어=n.指甲油
재발급=n.證照重發
이태원=n.梨泰院
외부인=n.外部人
과적=n.過積,過載,超載
마법=n.魔法
야수=n.野獸,棒球野手
당분=n.糖分
발육=n.發育
미치광이=n.瘋子,狂人
수레=n.車
썰매=n.雪橇
부조=n.浮雕
부조.1=n.1.天氣、健康不調.不正常.失調.不順
부조.2=n.2.扶助.資助.接濟
상호.1=n.1.商號
경련=n.痙攣
경련.1=n.1.抽動,顫動
동감=n.繪畫、雕刻、攝影等動感
굽이=n.彎,道彎
서두=n.開始,開頭
서두.1=n.文章的開頭
자발적=n.自發的,自主的
종기=n.腫氣,膿包
종기.1=n.1.終期,最後的期限
순잎=n.嫩芽
뽕잎=n.桑葉
고치.1=n.1.紡線用棉條
헛배=n.腹脹
뇌성=n.雷聲
니퍼=n.鉗子
사랑.1=n.1.舍廊,外堂,外屋
파운데이션=n.粉底霜,foundation
커버력=n.覆蓋力
플랜=n.計劃,plan,方案
방략=n.謀略,方略
성립=n.成立,談成
성립.1=n.1.省立
매니큐어브러시=n.指甲刷
매니큐어리무버=n.洗甲水
기미=n.氣味
저승=n.黃泉,陰曹
저세상=n.저승的別稱,黃泉
병상=n.病狀,病情,病床
탈취=n.脫臭,除臭
탈취.1=n.1.奪取,掠取
비녀=n.簪子
비녀.1=n.1.埤女,侍女
색상별=n.各顏色
생사고락=n.生死與共
사탕수수=n.甘蔗
시리얼=n.序號
시리얼.1=n.穀物,燕麥
삭제=n.刪除,清除
삭제키=n.刪除鍵
계정=n.帳戶,帳目
삼시세끼=n.三食三餐
현역=n.現役,軍人
현역.1=n.1.現職,現任
행동거지=n.行動舉止
개인행동=n.個人行動
흥정=n.講價,討價還價
철자=n.拼音
철자.1=n.1.鐵尺
대문자=n.大寫文字
숫자기=n.數字機
열세=n.劣勢
기일.1=n.1.奇數日
마감기일=n.截止日期
철야=n.徹夜,通宵
거름=n.肥,糞,肥料,堆肥
똥거름=n.糞肥
만두국=n.餃子湯
덜렁이=n.冒失鬼
생가죽=n.生皮
깝대기=n.外殼
껍데기=n.皮,殼
그물=n.網,圈套
그물눈=n.網眼
구리=n.銅
구리그물=n.銅網
그물버섯=n.牛肝菌
구성붓=n.合成毛筆
적자.1=n.2.嫡子
적자.3=n.3.賊子,不孝子
적자생존=n.適者生存
누적적자=n.累積虧損
국채=n.國債
에탄올=n.ethonal,乙醇,酒精
프리=n.free,免費,免稅
속수무책=n.束手無策
거드름=n.傲慢,架子거만한 태도
콧대=n.鼻樑
교정=n.校正,校對
교정.1=n.1.校庭,學校操場,校園,學校
혹.1=n.1.負擔,汙點,毒瘤
불필요=n.不必要
살덩어리=n.肉團,肉塊,略語살덩이
정돈=n.整頓,整理,收拾
정돈.1=n.停滯,停頓
슈퍼주니어=n.superjunior
일어=n.日語，일본어略語
쨈=n.果醬
사명감=n.使命感
한숨.1=n.1.嘆息,嘆氣
개장=n.股市開盤,營業開店,開業,開門
급락세=n.股票暴跌
초지=n.出志,初衷,初心
조치=n.措施
물량=n.物量;數量
내일모레=n.明後天
내일쯤=n.明天可能…
기침.1=n.敬語:起床,起來
마음눈=n.心眼,心計
마음고생=n.操心,費心
마음공부=n.修身養性,精神修養
마음자리=n.心地,心術
종합운동장=n.綜合運動場
감면혜택=n.減免優惠
세제혜택=n.稅務優惠
은택=n.恩澤
장면.1=n.情景,場景
격투=n.格鬥,搏鬥
격두장면=n.武打場面
가상장면=n.虛擬場景
극적=n.戲劇性,神奇
면목=n.體面,面目,臉面,面子
감탄=n.感嘆,讚嘆,嘆服
정도.1=n.1.正道,正路
정도.2=n.2.定都
정도.3=n.3.政道,施政方針
정도.4=n.4.征途,旅途
정도.5=n.5.定道,公理,命運
입담=n.口才
낙조=n.落照,夕照
낙조.1=n.1.落潮,汐潮
휴무=n.休息
누락=n.落漏,遺漏,落下,落掉
삭발=n.削髮
꺼풀=n.眼皮
윗눈썸=n.上睫毛
윗눈시울=n.上眼眶,上眼圈
윗눈꺼풀=n.上眼皮
쌍꺼풀=n.雙眼皮
안구=n.眼球
뭔가=n.什麼
아랫눈꺼풀=n.下眼皮
눈물샘=n.淚腺
자체.1=n.字體
도출=n.判斷、結論、反應、想法等導出,得出
스크린=n.screen.螢幕
본토=n.本土
곱셈=n.乘法
낙서금지=n.禁止亂圖、亂畫
봄 향기=n..春日香氣
들꽃 향기=n.野花香氣
민트 향기=n.薄荷香氣
라벤더 향기=n.薰衣草香氣
견습=n.學習,實習
견습공=n.見習工,學徒工
수습공=n.見習工,eq.견습공
철수=n.鐵銹쇠에 생기는 녹
철수.1=n.1.撤回,撤軍,撤出
생가슴=n.無可奈何的苦惱,操心,著急
몸석=n.體內,自身
월드컵공원=n.世界盃公園
점차.1=n.1.分數差
세일=n.sale,推銷,銷售,優惠,降價銷售
단자=n.單字,帖
단지.1=n.1.罐子,罈子
단지.2=n.2.小地,園區
모두.1=n.1.大家,全體,所有人
모두.2=n.2.冒頭；話或文章開頭
티눈고약=n.雞眼膏
무조건반사=n.無條件反射
교육과정=n.課程
교육부=n.教育部
길이.1=n.1.時間長短
비린 성물=n.讓人噁心的禮物
여럿이=n.許多人,不少人,一些人,幾個
옮겨심기=n.移栽
옮겨보내기=n.轉出.roll out
신세.1=n.1.得到幫助,沾光,關照,恩情
1영상=n.1.映射,影像,視頻
영상.2=n.2.領相
영상.3=n.3.靈床
시장제한=n.市場限制
기출문제=n.歷屆試題
스파게티=n.義大利麵
명작=n.名作,名著
수긍=n.首肯,同意,贊同
덮밥=n.蓋飯
덮어쓰기=n.覆蓋,overlay
덮개=n.蓋子
귀덮개=n.耳包
방석덮개=n.座墊套
덮개유리=n.蓋片
아가미덮개=n.鰓蓋
자동차덮개=n.車套
배 덮개 이불=n.蓋肚被子
귀덮개 키즈 모자=n.兒童護耳帽
키즈=n.兒童kids
덮어씌우기=n.覆蓋
공경=n.恭敬,公卿
경상남도=n.慶尚南道
창녕군=n.昌寧郡
경상북도=n.慶尚北道
도천면=n.都泉面
고령군=n.高靈郡
덕곡면=n.德穀面
김천시=n.金泉市
아포읍=n.牙浦邑
잇 아이템=n.熱點商品
잇 아이템 야상=n.item戶外服
데님 아이템=n.牛仔商品
리넨=n.亞
구호.2=n.2.看護,護理
구호선=n.救助船
딱장대=n.厲害的人,堅強的人
자사=n.本公司
타사=n.它社,別的公司
올려놓기=n.load,加載
세단=n.普通轎車,sedan
각성=n.清醒,清醒
외관=n.外觀,外表,表面
외관.1=n.1.外官,地方官
결구.1=n.1.結局.結果
살갗=n.皮膚,肌膚
종지=n.終止
종지.1=n.1.接踵而至
따로따로의=n.分離的,獨立的,不相連的
따로국밥=n.牛骨湯飯
덫=n.補獸器夾子
덫.1=n.1.比喻圈套,陷阱
구이그물=n.燒烤網
그물바늘=n.結網針,織網針
걸레=n.抹布,撚布
걸레차=n.拖布車
영업잠시정지=n.營業暫時停止
정지.1=n.1.靜止,靜態
정지.2=n.2.剪枝,整枝
정지.3=n.3.整地,平整土地
사료.1=n.1.史料
사료.2=n.2.思料,認為
사료.3=n.3.估計,預料
무료.1=n.1.無聊
무료.2=n.2.尷尬,難堪,為難
부스럼=n.瘡
호환성=n.互換性,相容性
보리차=n.大麥茶
상위호환성=n.向上相容性
하위호완성=n.向下相容性
하도급=n.下都給.轉包
하도롱지=n.牛皮紙
재생 크림=n.再生霜
당사=n.當社.本公司
인식.1=n.1.識別.感知
필기=n.筆記
필기인식=n.手寫辨識
해당.1=n.1.合適.適用.相當
해당기능=n.該功能
기능.1=n.1.機能,功能
단일화=n.單一化,統一
검증의뢰=n.驗證委託
런칭=n.launching.首發.上市
전이=n.轉移
전송=n.轉送.移交
바이너리=n.binary
유지.7=n.7.諭旨,聖旨
유행.1=n.1.遊行,瀏覽,遊歷
유행.2=n.2.流行.只傳染病蔓延
수중유행=n.睡中遊行.夢遊
유행 옷=n.時裝
유행 가방=n.流行包
유적.1=n.1.幽寂.幽靜
유적.2=n.2.流賊.流寇
포괄승계=n.總括繼承
외벌노=n.紙繩
돈오=n.頓悟,頓然醒悟
어조=n.語調,腔調
연약=n.煉藥,熬藥
매듭 볼=n.打結球
낚싯줄=n.魚線
증명서=n.證明,證書,證件
진로.1=n.1.進路,前進的道路
진로지도=n.進路指導,出路指導,前途教育
동정.2=n.2.童貞
동정.3=n.3.東征
동정.4=n.4.韓服的領邊
동정표=n.同情票
양과동정=n.(地名)良瓜洞亭
막내아들=n.老兒子,老小子
아들자=n.遊標
말썽꾸러기=n.惹事鬼.搗蛋鬼.搗亂分子
바가지.1=n.1.妻子對丈夫的嘮叨.牢騷
바가지.2=n.2.高的離譜的費用或物價
궁극=n.窮極,最終,最後
도통.3=n.3.道統
성현=n.聖賢
안달=n.前一個月,前月
안달.1=n.1.著急,焦急,焦躁
초조.1=n.1.月經出潮,初經
열성.1=n.1.劣性
열성.2=n.2.急性子.熱性
경력사원=n.經歷社員.有經驗的員工
물음표=n.問號
물음대이름씨=n.疑問代詞
보증=n.保證
파손=n.破損,損壞,破壞
공중파방송=n.公眾波放送,公共電視廣播
유성=n.遊星,行星
부동=n.勾結,串通
산장=n.山莊
산장.1=n.1.活埋,山葬
한복판=n.中央.中心
방명록=n.芳名錄.簽名簿.留言版
저리.1=n.1.低利
부동.1=n.1.浮動,流動,不穩定
유럼선=n.遊船.遊輪
유사점=n.相似點,類似點
오의=n.奧義,深意
호의=n.好意,善意
회답=n.回答,答覆
유지.8=n.8.有志,名人
부적=n.附籍,寄於他人戶籍的戶口,新入戶籍
부적.1=n.1.畫符,符咒
부적.2=n.2.簿碟.公文和文書
수양.1=n.1.收養
개인감정=n.個人感情,個人成見,個人情緒
감정싸움=n.感情糾紛
손익감정=n.損益帳戶,損益科目
감정가격=n.鑑定價格,評估價格
통솔력=n.統帥能力
관려=n.關聯,關係,相關
오물세=n.垃圾費
수양딸=n.養女
롯데월드=n.樂天世界
확인서=n.確認信
준말=n.縮寫詞
상태.1=n.1.狀態
내치.1=n.1.內治,治內
알몸=n.裸體。赤身。光身。光腚,벌거벗은 몸.
알몸.1=n.1.一無所有,赤手空拳,白手
짝짜꿍이=n.搞鬼,串通,爭吵
성품=n.性品,品性,脾性,性情
암치질=n.(-痔疾),內痔
얼마쯤=n.些許
살살이=n.滑頭.馬屁精
붉은 노을=n.紅霞
붉은 대추=n.紅棗
붉은색=n.紅色.赤色
볽은 사원=n.紅色清真寺
전면=n.前面.前方
전면.1=n.1.全面
전면.2=n.2.整面.整版
새벽종=n.晨鍾
진홍두깨=n.搗衣的濕捶
마른홍두깨=n.幹擣衣。(用擣衣棒卷半幹的衣服捶打)
고독=n.孤獨,蠱毒
고독단신=n.孤獨單身,孤苦伶仃,孓然一身
거통=n.一表人才,虛名,有名無實
사회.1=n.1.司會,主持
사회.2=n.2.主持人,司儀
장비.1=n.1.裝備
구명장비=n.救生裝備
제설장비=n.除雪裝備,制雪裝備,造雪裝備
구명=n.舊名,舊稱
구명.1=n.1.救命,救生,營救
구명.2=n.2.究明.探討.查明.弄清楚
구명도생=n.茍命圖生.苟且偷生
소수.1=n.1.少數
소수.2=n.2.疏水.引水渠.水利
소수.3=n.3.依賴名詞：多,有餘
소수점=n.小數點
소수대표제=n.少數代表制
사리=n.事理,道理
사리.1=n.1.私利,個人利益
급냉=n.急速冷凍
단골.1=n.1.短骨
쉽핑=n.shipping.運輸,運輸業
가오슝=n.高雄
판교=n.板橋
팬더=n.熊貓.panda
먹을거리=n.吃的.飯菜.食物
달팽이=n.鍋牛
돌솥=n.石鍋
돌솥비빔밥=n.石鍋拌飯
취침=n.就寢.入寢
취침등=n.小夜燈
주역샌생=n.周易先生.算命先生
동감.1=n.1.同感
대풍=n.大風.大豐收
만고대풍=n.萬古大豐.罕見的大豐收
정면충돌=n.正面衝突.迎頭相撞
정면공격=n.正面攻擊
선반=n.旋盤,車床
동맹=n.同盟,聯盟
솜먼지=n.棉塵
알콜솜=n.棉球
논리.1=n.1.倫理.道理
유발=n.誘發
유발.1=n.1.遺髮.故人的頭髮
유방=n.乳房
유방.1=n.1.遺芳.流芳
유방암=n.乳腺癌
구석빼기=n.背角,旮旯,犄角
야와휴게공간=n.露天休息站
덮개.1=n.1.被子,毯子等蓋的東西
덮개.2=n.2.佛教用於語瞋目,瞋心
한번.1=n.1.表示試試,可能的話
한번.2=n.2.主要用於口語,非常,很
경주자=n.跑步者
정부.1=n.1.情婦,情夫
정부.2=n.2.正負,正副
경영주=n.經營主
동전교환기=n.硬幣兌換機
동전파우치=n.硬幣包
각도=n.數學中的角度
각도.1=n.1.觀察事物的角度,方面
각도.2=n.2.刻刀
품위=n.品位,風格
품위.1=n.1.體面,品德
정신.1=n.1.挺身,獻身
정신.2=n.2.忠臣
총괄주의=n.總括原則
이재=n.理財
난생처음=n.生來第一次
아침녘=n.早晨,早上
정치.1=n.1.情致,情趣,興致
정치.2=n.2.情癡
초대.1=n.1.出對,初次見面
초대.2=n.2.初代,首任,第一代
초대.3=n.3.初…，生手
로비=n.大廳,lobby
목이버섯=n.黑木耳
흰목이버섯=n.白木耳
경제침체=n.經濟停滯
조로=n.朝露,晨露
조로.1=n.1.早老,早衰
도로망=n.道路網,公路網
강변도로=n.江邊道路,沿江公路
도로건설=n.道路建設,公路建設
도로경주=n.道路競走,自行車公路賽車
도로명판=n.路牌,公路指示牌
도로무익=n.徒勞無益
도로벽돌=n.路面磚
조강=n.糟糠
조강.1=n.1.粗鋼
조강.2=n.2.條鋼,條型鋼
조강.3=n.3.朝講
조강지처=n.糟糠之妻,結髮之妻
껍데기.1=n.1.外殼
빈껍데기=n.空殼子,徒有其表,虛有其名
겉껍데기=n.外殼,外表,外皮
조개껍데기=n.貝殼
유명.1=n.1.遺命,遺教
유명.2=n.2.幽冥,幽暗
유명.3=n.3.明與暗,陰間與陽間
입말=n.口語
억지=n.執著,固執,倔
억지.1=n.1.牽強,不講理,賴
억지.2=n.2.抑制
진정.1=n.1.陳情
진정.2=n.2.真情.實情
진정.3=n.3.鎮靜
진정.4=n.4.鎮定.平定.平息
진정.5=n.5.真正.真的
진정.6=n.6.進呈.呈上
나눗셈표=n.除號
판매가=n.售價,販賣價,銷售價
감가판마=n.減價銷售,折價出售,削價出售
가납판매=n.試用銷售 sales on approval,假納販售
가납=n.嘉納,欣然接受,笑納
가납.1=n.1.假納,臨時繳納
영감.2=n.2.令監。敬稱“영감마님”。(對從二品、正三品的稱謂)
앞가리마=n.中分
연장.2=n.2.艷妝,年長
기운.1=n.1.氣氛
기운.2=n.2.病情가벼운 병의 증세
알은체=n.理睬.理會
알은체.1=n.打招呼
낱낱=n.個個
목마름=n.渴,渴望,渴求
여물.1=n.1.鹹井水
손톱깎이=n.指甲刀
손톱자국=n.指甲印
수효=n.數目,數量,數爻
황달=n.黃疸
적진=n.敵陣
조금.2=n.2.低潮,潮位最低的陰曆初八和廿四
조금.3=n.3.造金,人造黃金
조금.4=n.4.雕金
전형적=n.典型的
사례.1=n.1.謝禮,謝意
사례.2=n.2.四禮,指冠禮,婚禮,喪禮,祭禮
승부사=n.勝負師,終結者
승부수=n.棋累等勝負手,絕招,關鍵著
승부주=n.關鍵株,決定大盤走勢的關鍵股,key stock
방비=n.防衛,戒備,防範,防守,防備
방비책=n.防備策,防備措施,防範措施,防守措施
지능적 주변장치=n.智慧型設備 (intelligent peripheral)
주변장치 드라이버=n.外部設備驅動程式
부정.1=n.1.否定
부정.2=n.2.不淨,不潔,邪氣
부정.3=n.3.不定,不確定
부정.4=n.4.不貞,不倫,偷情,有染
모둠생선회=n.生魚片拼盤
생선찜=n.蒸魚
생선찌개=n.鮮魚湯
생선소스=n.魚露
생선젓갈=n.魚醬
생선조림=n.紅燒魚
생선초밥=n.壽司,生魚片蓋飯
생선튀김과 칠리소스=n.炸魚與辣椒醬
생선슬라이싱용식칼=n.鮮魚切片刀
고등어생선구이백반=n.烤靖魚家常套餐
생선요리용나이프=n.魚刀
참치생선구이백반=n.烤土魠魚套餐
꽁치생선=n.秋刀魚
굴비생선=n.黃玉
생선요리용포크=n.魚叉
산꼭대=n.山頂風,夜裡刮的寒風
공중제비=n.翻跟鬥,後空翻,空中燕子
신신당부=n.一再囑咐,拜託,叮嚀
시골집=n.農家,老家
시골고라리=n.鄉巴佬,土包子
제비뽑기=n.抽籤
불화=n.不合
불화.1=n.1.氟化
생산사업=n.製造業,生產事業
재주꾼=n.有才幹的人,多才多藝的人
중구난방=n.眾口難防
중앙난방=n.中央暖房.集中供熱
난방비용=n.取暖費
난방설비=n.暖氣設備
필름 난방=n.發熱墊
호미난방=n.虎尾難放.騎虎難下
난방 텐트=n.保暖帳篷
천사.1=n.1.遷徒.遷徙
정상.6=n.6.晶相.晶狀.結晶的情況
고상=n.翱翔.悠轉
고상.1=n.1.高翔.飛翔
고상.2=n.2.天主教十字苦像的略語
귀밑=n.鬢角
귀밑샘=n.腮線.耳下線
귀밑털=n.鬢毛
하위체계=n.子系統,下位體系
행정체계=n.行政體系
시각적=n.視覺上的，視覺
맞선=n.相親
먼데=n.遠處,婉言指廁所
꼼데 셔츠=n.comme des襯衫
청탁=n.請託,委託,託付
청탁.1=n.1.清濁
청탁병탄=n.相容並蓄.相容並包.清濁並吞
상처.1=n.1.喪妻
이상.4=n.4.奇怪.古怪.離奇
이상.5=n.5.可疑
이상.6=n.6.理想
차핸들=n.車把
도어핸들=n.門把手
이승=n.現世,塵世
초지.1=n.1.草地
나사=n.螺絲
에너지원 개발=n.能源開發
일률적=n.一律的
공급과다=n.供給過多,供大於求
과다=n.過多
출가=n.出家,出嫁
기념관=n.紀念館
기념사진=n.紀念照
항의.1=n.1.降意
상혈=n.上血,吐血,漲紅
얌전=n.規矩,斯文,文靜
깃=n.羽毛,翅膀
자연도태=n.自燃淘汰
인위=n.人為
인질=n.人質
훼방=n.毀謗,阻撓,妨礙
훼방군=n.阻撓的人,搗亂鬼
솔발=n.用於軍令或報警的大銅鈴
교료=n.校了,校對,核對
증가.1=n.1.增價,漲價,提價,加價
대오=n.隊伍,隊列
대오.1=n.1.大悟,醒悟
가지가지=n.許多種,多種多樣
체머리=n.搖頭風,一種痛震
평안=n.平安,安寧
종양=n.腫瘤
고환=n.睪丸
제거=n.除去,清除,消除,排除,掃除
대뇌=n.大腦
대뇌제거=n.大腦切除術
각질제거=n.去角質
구취제거=n.消除口臭
붓기제거=n.消除腫脹
자중=n.自重,自身重量
돌가루=n.石粉
콩가루=n.豆粉
마늘싹=n.蒜苗
어린싹=n.幼苗
소개.1=n.1.疏開,疏散,散開
소개임=n.傭金,介紹費,紹介賃
밀어=n.密語,情話,甜言蜜語
밀어.1=n.1.密語,祕密話
밀어.2=n.2.密漁,私自捕魚,非法捕撈
새로만들기=n.新建,creation
순풍=n.順風
실과=n.實科,常識課
사실.1=n.1.寫實
사실.2=n.2.史實
아주.2=n.2.亞洲
주는자=n.捐獻者
접는 자=折尺
워킹 자=n.角度尺
일화.1=n.1.日貨.日本貨
일립티컬=n.踏步機
각기.1=n.1.腳氣
각기.2=n.2.限期,刻期,克期
초과정박=n.滯期,誤期,滯港,裝卸誤期demurrage
저저축=n.低儲蓄lower savings
동안.1=n.1.童顏,娃娃臉
동안.2=n.2.東岸
임시.1=n.1.壬時,(24時制的第24時，即22時30分至23時30分)
고립=n.孤立,隔絕
부호=n.符號,記號
부호.1=n.1.富豪
부호.2=n.2.負號
감탄부호=n.感嘆號
모스부호=n.摩斯密碼
문장부호=n.標點符號,文章符號
주음부호=n.注音符號
부호자물쇠=n.密碼鎖,字碼鎖
마침표=n.句號
자리표=n.座標,座位票
경로표=n.路由表
가새표=n.(表示錯的符號)叉號
곱셈표=n.乘號
꺾쇠표=n.方括號
난수표=n.亂數表
덧셈표=n.加號
로그표=n.log表
뺄셈표=n.減號
성위표=n.星位表
시력표=n.視力表
연대표=n.年代表
운임표=n.運價表
이유표=n.理由標,原因符號。倒三點。即“∵”。
정지표=n.停止標,停止標誌
말바꿈표=n.破折號。북 찌레표.(符號“—”)
말없음표=n.省略號。(“…”)
가랑이표=n.符號“<”，表示“小於”
갈고리표=n.“§”，段落號。
게발톱표=n.雙引號。(即“ ”)
나누기표=n.除號
새발톱표=n.單引號
표 받는 곳=n.檢票口
동그라미표=n.圓圈符號。(對號)
소풍마당=n.郊遊小廣場
전세.1=n.1.戰勢,戰爭形勢
전세.2=n.2.前世
전세.3=n.3.田稅,田租
머리핀=n.髮夾
깃머리=n.牛腩
머리숱=n.頭髮疏密
선머리=n.開頭.開始
딴머리=n.假髮,裝飾髮
머리끈=n.髮帶
머리빗=n.梳子,木梳
후머리=n.後頭,後邊,末尾
고수머리=n.髮捲
곱슬머리=n.고수머리髮捲
까까머리=n.光頭
단발머리=n.短髮
상고머리=n.平頭
생량머리=n.秋涼
소갈머리=n.心眼,心術,心胸,心思
파마머리=n.燙髮
책상머리=n.案頭,書桌邊
해토머리=n.解凍時節
더벅머리=n.蓬頭,頭髮亂蓬的人
도가머리=n.刺蝟頭
머리받침=n.頭靠,座椅頭枕
머리정보=n.題目,標題
머리치장=n.美髮
바람머리=n.受風,頭痛病
지정머리=n.醜事,醜態,醜行
침대머리=n.床頭
합수머리=n.江河匯流處
납작머리못=n.扁頭釘
머리염새솔=n.染髮刷
저금통=n.存錢筒
사우나탕=n.桑拿浴池
여자아이=n.女孩
수납장=n.收納櫃
마주조림=n.紅燒鰭魚
천선=n.天仙,從善
팝콘=n.爆米花
하야=n.下野,下臺
관행=n.慣行,慣例,習慣
노자=n.路資,路費,盤纏
노자.1=n.1.勞資
대중적인 서적=n.普級讀物
석.4=n.4.(用於‘장, 달, 자, 냥, 되’等量詞前)三
석비=n.石碑
눈꼴=n.眼睛,眼神,目光(用於貶抑之詞)
지형=n.地形
지형.1=n.1.紙型,紙板
집회=n.集會
돌출=n.突出,突發
다단=n.多段
파일.1=n.1.絨毛織物
파일복=n.filebook.活頁筆記本
킬 파일=n.kill file,清除檔
주 파일=n.主文件,primary file
파일 끝=n.文件結束
공용파일=n.共用檔,shared file
구성파일=n.設定檔,configuratuon file
파일경로=n.文件路徑,file patch
파일직물=n.起絨織物
공유 파일=n.共用檔,공용파일
목적 파일=n.目標文件,destination file
보존 파일=n.存檔文件,archive file
숨은 파일=n.隱含文件,hidden file
스왑 파일=n.交換文件,swap file
실행 파일=n.執行文件,execution file
압축 파일=n.壓縮文件,compressed file
원시 파일=n.原始檔,source file
이진 파일=n.二進位文件,binary file
자료 파일=n.數據文件,data file
잠긴 파일=n.鎖定文件locked file
전자 파일=n.電子文件
파일 개신=n.檔更新,update file
파일 복구=n.文件恢復,file recovery
파일 복원=n.文件恢復,파일 복구
파일 속성=n.文件屬性,file attribute
파일 속지=n.文件備用袋
파일 잠금=n.文件鎖定file locking
파일 전송=n.文件傳送,file transfer
파일 종료=n.文件結束
파일 카펫=n.絨毛地毯
파일 형식=n.檔案格式,file format
파일 홀더=n.文件夾
표준파일=n.標準文件,standard file
화상 파일=n.圖像文件,image file
파일 서버=n.文件服務器,file server
걸개식파일=n.掛式文件夾
데이터파일=n.數據文件,data file
리포트파일=n.報表文件,report file
마스터파일=n.主文件,master file
커리어파일=n.人事檔案,career file
텍스트 파일=n.文字檔,text file
파일 인덱스=n.檔索引,file index
파일 정리함=n.檔整理箱
아카이브 파일=n.存檔archive file
파일 확장명=n.文件擴展名,file extension name
파일 확장자=n.文件擴展,file extension
파일재생기능=n.檔播放功能
광디스크 파일=n.光盤文件
기운.3=n.3.氣運,氣氛,空氣,氣勢,跡象,氣象
불기운=n.火勢,火力,熱氣
땅기운=n.地氣
밤기운=n.夜間氣息
봄기운=n.春天的氣息,春色,春意
술기운=n.酒意
가을기운=n.秋意
신진=n.新進,新,新興
선진.1=n.1.先陣
선진사회=n.發達社會
법규범=n.法律規範,法規範
도덕규범=n.道德規範
실재=n.實在,真實
실재 사건=n.真實事件
샴쌍둥이=n.連體嬰
걸레부정=n.破爛,破鞋
기름걸레=n.油拖布
마른걸레=n.乾抹布
팔짱=n.挽手臂,袖手
놀이감=n.玩具
요트=n.快艇,遊艇,小帆船
인물가난=n.人材難找
정치.3=n.3.沒卵的銀魚,白魚
정치가=n.政治家,정치인
출시=n.出市,marketing,上市
가벼운 병=n.輕微的病
증세.1=n.1.增稅
토대 위=n.基礎上
오래된=n.陳舊的
불현성감염=n.潛伏感染,不顯性感染
원조=n.援助
원조.1=n.1.元祖,始祖,鼻祖,創始人
원조.2=n.2.遠祖
개술=n.概論,概述
개로=n.開路,開啟
멀미=n.車、飛機、船等暈
멀미약=n.暈車藥
사람멀미=n.人多頭暈
개의=n.改議,再議,重議,重新提議動議案
개껌=n.狗磨牙棒
개의.1=n.1.大意,概意
개의.2=n.2.在意,介意
성냥=n.火柴
성냥노리=n.(舊時鐵匠到臘月)收賬
안전성냥=n.安全火柴
개잠=n.捲著睡
개싸움=n.狗打架,比喻狗咬狗
잃어버린 고리=n.滅絕的物種
일어난 일=n.發生的事
메모꽂이=n.名片夾
메모리북=n.紀念冊,簽字本
메모 패드=n.記憶板
메모 홀더=n.便籤夾
메모 스티커=n.便籤貼
메모보드=n.留言版
고의적 결근=n.故意缺勤,曠工
시점.1=n.1.視點,角度
시점.2=n.2.時點,時候,時機
현시점=n.現在,目前,當前
높음=n.高
방역소독기=n.防疫消毒氣
방역 마스크=n.防疫口罩
나무걸상=n.木凳
네모걸상=n.方凳
둥근걸상=n.圓凳
대나무걸상=n.竹凳
네모=n.四角,四方
네모송곳=n.四角錐
회사.1=n.1.會士。(朝鮮時期，戶曹從九品官)
고적.1=n.1.對官吏的考績
공개키=n.公開密鑰,public key
공개경쟁=n.公開競爭
대개.1=n.1.大部分,大體
추첨=n.抽籤
두루마리신문용지=n.捲筒新聞紙
두루마리 구름=n.捲積雲
그림 두루마리=n.畫捲
중매.1=n.1.仲買.介紹生意
보통.1=n.1.普通,一般,平常
매미=n.蟬
기계.3=n.3.器械
괴성=n.怪聲
굉음=n.轟音,轟鳴聲
기척=n.動靜,聲響,聲息
깍지=n.(箭手在拇指上戴的)扳指兒。
깍지.1=n.1.殼
지퍼 이빨=n.拉鍊齒
허두=n.虛頭,開頭
승냥이=n.狼
체격=n.體格
변경.1=n.1.邊境,邊疆
총격전=n.槍擊戰
자극적=n.刺激的
제법.1=n.1.除法
제법.2=n.2.像樣。夠好。相當不錯
제법.3=n.3.諸法。各種法律。
대상.2=n.2.代償
대상.3=n.3.隊商,沙漠地帶的商隊
대상.4=n.4.大賞,大獎
대상.5=n.5.大商人。鉅賈。巨賈
대상.6=n.6.貸上, (中央銀行)向政府提供貸款。
대로.2=n.2.大路.大道
대로.3=n.3.大路,憤怒
대로.5=n.5.大老,老仗,老人家
시간.1=n.1.姦屍,屍姦
주식.1=n.1.主食
주식가격=n.股價
주식붐=n.股票熱,股市景氣 stock market boom
도지이론=n.(廣告)道奇理論 Dodge theory,冰山理論
과점이론=n.壟斷理論 oligopolistic theory,寡佔理論
공사.1=n.1.貢使。(掌管進貢的使臣)
공사.2=n.2.供詞
공사.3=n.3.公私
공사.4=n.4.공군 사관 학교(空軍士官學校)”的略
공사.5=n.5.법률公社。(國有企業、事業單位)
공사.6=n.6.公使
공사.7=n.7.公事
기한.1=n.1.飢寒･饑寒
협정=n.協定
날것=n.生的,為加工的
어리=n.門窗,門框
전화벨=n.電話鈴
동녘=n.東邊,東方
구정=n.舊正,春節,陰曆年,正月
구정.1=n.1.舊情
원망=n.願望,心願
원망.1=n.1.遠望,遙望
원망.2=n.2.埋怨。抱怨。怨恨。
계승자=n.繼承人。後繼者。接班人
계승=n.繼承
계승.1=n.1.階乘。(以來表示)
상속=n.繼承,相續
상속법=n.繼承法
그이.1=n.1.(對別人稱呼自己的)丈夫
우로=n.向右
글귀=n.語句, (讀書、學習中的)理解能力
결국.1=n.1.結局。結果。到底。終究。
결국.2=n.2.成型。定局。
가서=n.家書。家信
가서.1=n.1.佳婿
연기.1=n.緣起,預兆,徵兆
땅.1=n.1.國土,領土
땅.2=n.2.地皮,土地
연기.2=n.2.煙,煙氣
연기.3=n.3.延期。推延。延遲
연기.4=n.4.年期,年
연기.5=n.5.年紀,年譜
필터=n.過濾器,filter,濾光鏡,濾波器
색필터=n.濾色器
필터백=n.過濾袋
필터팁=n.過濾嘴
건식필터=n.乾式過濾器
에어필터=n.濾氣器。空氣篩檢程式。空氣濾清器
습식필터=n.濕濾器
여과필터=n.濾蕊
오일필터=n.濾油器。機油濾清器
카본필터=n.活性炭篩檢程式。 (carbon filter (영))
항균필터=n.抗菌過濾器
수다=n.囉唆。嘮叨。絮叨。貧嘴
수다식구=n.數多食口,眾多家口。大家子
경사.7=n.經師
겨울새=n.候鳥
구정물=n.(洗刷用過的)污水。髒水
구정물.1=n.1.膿水
주유=n.周遊
주유.1=n.1.(給車輛、機器)加油。注油。
몇살=n.幾歲
몇시=n.幾點
몇년=n.幾年
이삼 일=n.兩三天
엿=n.六
대판거리=n.大規模。大場面。大排場。
대판=n.大規模。大場面。大排場。대판거리略語
대판.1=n.1.代辦
대판.2=n.2.代還,代償
대판.3=n.3.(書、紙、相片等)大版。大開
대판.4=n.4.大字版本
거리.1=n.1.巨利。暴利
거리.2=n.2.黃瓜、茄子等的計量單位，50個
강설=n.講說
강설.1=n.1.強雪
강설.2=n.2.降雪,下雪
표창=n.表彰。表揚。獎勵
표창.1=n.1.標槍
표창메달=n.獎牌
티비=n.TV
티비프로그램=n.電視節目
단 음식=n.甜的食物
친절한 사람=n.親切的人
섹시=n.性感
섹시룩=n.性感裝
태산=n.泰山,高山
단련=n.身心鍛鍊
단련.1=n.1.把鐵鍛鍊
단련.2=n.2.磨練。錘煉。煉就
단련.3=n.3.折磨
친선=n.親善,有好
단결=n.團結
단결.1=n.1.斷絕,裁決,決斷
파괴가격=n.破壞價格,跳樓價
환경파괴=n.環境破壞environmental disruption
파괴해머=n.破壞捶
제발.1=n.1.題跋。(題詞與跋文)
드라이기=n.吹風機
드론=n.遙控飛機
드라이버=n.球棒
씀씀이=n.開銷,花銷,花費
씀씀이.1=n.1.(用作‘마음 씀씀이’的形式)表示對某事或某人關心
물소리=n.水聲
소리의=n.聲音的，英語：acoustic
모깃소리=n.蚊聲,比喻微弱的聲音
울음소리.1=n.1.叫聲,啼聲
우렛소리=n.雷聲
죽는소리=n.叫苦,叫苦連天
오만소리=n.無話不說,說盡
경소리=n.誦經聲
왼소리=n.噩耗,兇信
볼멘소리=n.生氣的口吻,聲音
사잇소리=n.中間音
상엿소리=n.(出殯時抬著喪輿唱的)挽歌。送行號子
궁기=n.窮氣,窮酸,窮相
구미시=n.龜尾市
도개면=n.地名:桃開面
궁기.1=n.1.地名：宮基
궁지=n.窮地,困境,窘境
궁시=n.箭矢,弓箭활과 화살
궁리=n.窮理,想。琢磨。考慮。尋思
궁리.1=n.1.主意,辦法
여주군=n.地名：驪州郡
금사면=n.地名:金沙面
궁리.2=n.2.地名:宮裡
평택시=n.地名:平澤市
고덕면=n.地名:古德面
충청남도=n.忠清南道
홍성군=n.地名:洪城郡
구성.2=n.九成
자산구성=n.資產結構,資產構成 assets structure
자본구성=n.資本構成 capital structure
원가구성=n.成本構成
제품구성=n.產品構成
기생=n.寄生
기생.1=n.1.妓生,妓女,藝妓
한해=n.旱災
새삼.1=n.1.(Cuscuta japonica)金燈藤。菟丝子메꽃과에 속한 한해살이 기생 식물
모니터.1=n.1.(廣播、電視、電信)監測員。監視器。監控器
모니터.2=n 2.放射能探測器
관심.1=n.1.佛教的觀心
중과부적=n.寡不敵眾,眾寡不敵
경산시=n.地名：慶山市
압량면=n.地名：押梁面
부적.3=n.3.地名：夫迪
소수.5=n.數學的質數，素數
소수민족=n.少數民族
소수서원=n.地名：紹修書院
경계.3=n.3.醫學：驚悸
경계경보=n.警戒警報
경계관제=n.警戒管制。燈火管制
라이다경계=n.radar警戒
비상경계=n.非常警戒
농포=n.膿皰
형성.1=n.1.[언어학] 形聲。象聲。(漢字六書之一)
호수.1=n.1號數,刊物期數,(鉛字)字型大小,字畫號
호수.2=n.2.棒球、足球等善於防守,好守,防守高手
호수.3=n.3.虎鬚,粗鬚
호수.4=n.4.戶數
호수.5=n.好手,高手
호수요=n.需求看好 demand boom,好需要
가마호수=n.燒窯工
권장호수=n.建議尺碼
금광호수=n.地名：金光湖
막힌호수=n.堰塞湖
몽촌호수=n.地名：夢村湖
반월호수=n.地名：半月湖
백운호수=n.地名：白雲湖
산정호수=n.地名：山井湖
주문 가능 호수=n.可訂購尺寸
호수활자=n.號數鉛字,號數活字
전형원소=n.典型元素
지표.1=n.1.地表
경기지표=n.景氣指標
괴리지표=n.分散指標 divergence indicator,乖離指標
업적지표=n.成績指標 achievement indicator,業績指標
정액=n.精液
정액.1=n.1.定額,固定
데이터 서비스 정액제=n.行動網路資費
본방=n.直播
땀띠분=n.痱子粉
난백분=n.蛋白粉
감초분=n.甘草粉
양위분=n.兩位。(對父母或敬如父母的人的敬稱)
난황분=n.卵黃粉
발효분=n.發酵粉
활석분=n.化石粉
분문열호=n.分門裂戶,各立門戶
한숨.2=n.2.一覺。一會兒
접촉면=n.介面,介面,interface
접촉감염=n.解除感染
접촉법=n.接觸法
먼동=n.黎明的東方
순차=n.順序,次序
쇳물=n.鐵水,鐵銹水
달음질=n.奔跑
먹구름=n.烏雲,陰雲
먹구름.1=n.1.陰雲, 陰影。比喻不穩定或令人擔憂的事情的徵兆
어린이 유원지=n.兒童樂園
총알=n.子彈,彈丸,총알
자가운전=n.自己開車
안전운전=n.開車注意安全
양보운전=n.禮讓駕駛
배냥여행=n.自主旅行
물결.1=n.1.浪潮, 波浪물결처럼 움직이거나 밀어닥치는 모양
반사지경=n.半死之境,半死境地
빈사지경=n.瀕死地境,瀕死狀態
기관지경=n.支氣管檢查鏡。支氣管鏡
지경.1=n.1.枝與莖
전당포=n.當鋪
벗.1=n.1.(生火用)木碳或柈子
친한 벗=n.知己
생선국=n.鮮魚湯
죽어지만=n.罪該萬死
미숙한=n.發育未全的；不成熟的(英語：immature)
장날=n.集日,趕集日
포즈=n.姿勢,姿態
해바리다=n.向日葵
해비라기.1=n.1.曬太陽
변덕=n.變化,變卦,變化無常,翻雲覆雨,出爾反爾
경기.1=n.1.京畿
경기.2=n.2.驚氣,驚風。抽風
경기.3=n.3.驚起
경기.4=n.競起。競相而起。
경기.5=n.5.輕騎兵。“경기병(輕騎兵)”的略语
경기.6=n.6.輕機槍。“경기관총(輕機關銃)”的略语
금세 호결=n.今世豪傑
별.1=n.1.別,別的
탈.1=n.1病
탈.2=n.2.意外,事故
탈.3=n.3.差錯, 缺點, 毛病
갈림길=n.叉路
수탉=n.公雞
옛사랑=n.舊愛,舊情人
내리상랑=n.(長輩對小輩的)愛撫。疼愛
사랑싸움=n.小倆口鬥嘴。(戀人或夫妻之間的吵架)
큰사랑=n.家中長輩住的外堂。
사랑양반=n.男主人
한국.1=n.1.寒菊
한국.2=n.2.汗國。(可汗統治的國家)
스토어=n.store商店
첸인스토어=n.連鎖店。系列店
구글=n.google
플레이=n.音響機械等的播放
기색=n.氣色。臉色。神色。顏色。
기색.1=n.1.樣子。跡象
한집안.1=n.1.一家子
웃음꽃=n.歡笑
한 집안 식구=n.一家人似的
성황=n.盛況
현역 군인=n.現役軍人
현역 국회 의원=n.現任國會議員
이야기.1=n.1.說話,談天
옛이야기=n.故事,過去的事,發音:옌ː니야기
발치겸자=n.牙鉗。撥齒器。拔牙鉗。
죽순=n.竹筍
도처=n.到處,處處
명절.1=n.1.名節,名分和節義
잡채=n.雜燴, 什錦,雜菜
부추잡채=n.韭菜炒什錦菜
고추잡채=n.炒青椒什錦菜
곤약잡채=n.炒蒟蒻什錦菜
잡채덮밥=n.炒什錦菜蓋飯
부채춤=n.扇子舞
장사.1=n.1.葬禮。殯葬。
장사.2=n.2.大力士, 壯漢,狀士
기색혼절=n.氣塞昏絶
흰머리=n.白髮
노년=n.老年
노년적=n.老態龍鍾的(英語：senile)
앞머리=n.前腦。額頭
앞머리.1=n.1.前面的頭髮
앞머리.2=n.2.前頭。前部。
언행=n.言行
엄숙=n.嚴肅。莊嚴
도로수송=n.公路運輸 road transport
도로연석=n.路邊石
도로원표=n.路牌。路線標牌
산업도로=n.產業道路
반색.1=n.1.斑斕色彩
억압=n.壓制。壓迫,抑壓인간의 행동이나 자유 등을 강제로 억누름.
십자고상=n.耶穌受難像。
짧은 호미=n.手鋤
원예호미=n.園藝鋤
마루.1=n.1.(事情的)關頭。關鍵。節骨眼兒
마루.2=n.2.(山、屋等)脊。頂。梁。
마루.3=n.尖,峰
방.1=n.依存名詞,照相的次
방과=n.下課,放學
지면.1=n.1.紙面,報刊,版面,篇幅
지면.2=n.2.知面,面熟,初相識
건축.1=n.1.乾縮
전통.1=n.1.全通,全線通車
지면.3=n.3.(雜誌的)頁面。篇幅。
널빤지=n.木板,板子
반대면=n.對面,對方,反對面
유훈=n.遺訓
혼잡통행료=n.(首爾)隧道通行費,混雜通行料
뉴질랜드=n.紐西蘭
미세먼지=n.霧霾,微塵
근소세=n.勞動所得稅 earned income tax
오지=n.5指
오지.1=n.1.奧地,偏僻地區。偏遠地區。
박하사탕=n.薄荷糖
겹=n.重。疊。複。重複。
겹.1=n.1.夾。雙。兩。
겹.2=n.2.折。疊。層。
화살표=n.箭頭符號
화살표 패턴=n.箭頭圖案
혼란=n.混亂
소름=n.雞皮疙瘩。寒噤。不寒而慄。毛骨悚然
명사=n.名詞
명사.1=n.1.名辭。命題辭
명사.2=n.2.明沙
명사.3=n.3.銘謝
양.1=n.1.ㄌㄧㄤˋ量
양.2=n.2.指平順的人
야단.1=n.1.批評, 訓說
미완성품=n.半成品,未完成品unfinished goods
곧은 성품=n.耿直的品性
공격.1=n.1.駁斥,攻擊
공격.2=n.2.進攻
시위.1=n.1.侍衛
시위.2=n.2.洪水
오늬=n.箭尾凹口。
가정 도우미=n.社區服務隊員
청소 도우미=n.清潔員
가사도우미=n.褓姆
방식.1=n.1.防蝕。防腐
사고.1=n.1.四苦。(生、老、病、死之苦)
사고.2=n.2.思考。思維
사고.3=n.3.社告。公司告示
사고.4=n.4.(朝鮮時期)史庫。
사고.5=n.5.四庫。(整理中國唐代書籍的經、史、子、集)
고유=n.固有, 傳統, 專有
고유.1=n.1.告諭
고유.2=n.2.告由。(儒家的一種儀式，國和家有大事時把事由告於神明或祠堂)
쇠붙이=n.鐵,金屬, 鐵片
화포=n.畫布
화포.1=n.1.火炮
화포.2=n.2.花炮。煙花爆竹
화포.3=n.3.花苞
훈기=n.薰氣,熱乎氣
곁땀=n.掖汗,腋汗症
마른땀=n.冷汗
바늘땀=n.針腳
땀 패드=n.汗墊
땀투성이=n.滿身是汗。汗流浹背。
땀등거리=n.背心
땀방지제=n.防汗劑
대체.2=n.2.大體,大致
대체.3=n.3.代替,代替品
대체.4=n.4.對替,轉帳
대체전표=n.轉帳存根 transfer slip,對替傳票
대체결제=n.轉帳支付,對替決濟
대체제품=n.代替製品,substitutive goods,代替商品
품등=n.品等,質量等級
품안=n.懷裡,懷抱가슴으로 품을 수 있는 범위의 안
품인=n.廠牌,brand.品印
품 마크=n.質量標誌
자동차부 속품=n.汽車配件,汽車零件
설채=n.設彩,重採,塗採
체가=n.遞加,遞增
가는체=n.細篩子
침의=n.針灸醫生,鍼醫
침의.1=n.1.睡衣,寢衣
마른침=n.(口幹時的)黏唾液。
쇠기침=n.老咳嗽。慢性咳嗽
침케이스=n.針盒
티타늄 침 함금=n.鈦晶片合金
실버 침 세트=n.銀針套裝
블랙 침 수정=n.黑色發晶石。
알레르기 방지 침=n.防過敏針
귀걸이 침=n.耳針
가는침=n.毫針
버림치=n.閒置物,廢品
부재.1=n.不才
부재.2=n.2.不力。跟不上
역전=n.逆轉
역전.1=n.1.驛傳。驛送, [체육학] 接力賽。
역전.2=n.驛前,車站前
역전.4=n.4.歷戰,身經百戰
역전.5=n.5.力戰,奮戰
역전.6=n.6.逆戰,反擊。反攻
역전.7=n.7.驛田
역전 경주=n.(長跑)公路接力賽。馬拉松接力賽.驛傳競走
맨.1=n.1.冠詞：最
안내원=n.嚮導,帶路員
자원봉사안내원=n.志願導遊員
수로안내=n.領航,引水 pilotage
걸래안내=n.導購圖 store bulletin,購物指南
관람안내=n.參觀導覽
안내관고=n.分類廣告 classified ad
적하안내=n.裝船通知 advice of shipment
투자안내=n.投資指南 investment guide
법규=n.法規
일개=n.一介
꼭두각시=n.木偶,傀儡
막후 조종자=n.幕後操縱者
막후=n.幕後
조종.1=n.1.祖宗
조종=n.操縱
조종.2=n.2.吊鐘,喪鐘
기분.1=n.1.氣氛。氛圍。情調。
기분전환=n.注意力的轉移(英語：diversion)
공부.1=n.1.貢賦
공부.2=n.2.工部
공부.3=n.3.公簿,公賬。(官廳的帳簿)
세배=n.歲拜,拜年
평정=n.平靜
평정.1=n.1.平定,平息
평정.2=n.2.評定,鑑定
등급평정=n.等級評定 rating
근무평정=n.考績 personal rating
경력평정=n.履歷評定 career valuation
축제.1=n.1.築堤
불꽃축제=n.煙花節
등불축제=n.燈會
연봉.1=n.1.山巒.群峰.連峰
홍천군=n.地名:洪川郡
홍천급=n.地名:洪川邑
대체구좌=n.轉帳帳戶 transfer account,對替口座
대체계죄=n.劃拔帳戶 postal transfer account,對替計座
대체예금=n.可轉帳存款 transferable deposit,對替預金
모내기=n.插秧
가장.1=n.1.家長
가장.2=n.2.假裝, 裝作
가장매매=n.非法交易,虛假買賣 false trade, wash sales,假裝買賣
가장.3=n.3.臨時埋葬,假葬
병화=n.兵禍,兵亂
병화.1=n.1.兵火,戰火
평화주의=n.和平主義
평화광장=n.和平廣場
혁명=n.革命,變革
역성혁명=n.易姓革命,改朝換代
촉구=n.促求,催促,敦促
창원=n.地名:昌原
전주=n.地名:全州
수원=n.地名:水源
인파=n.人潮,人流
저항=n.抵抗
정신.3=n.3.(賽艇)艇身
매우.1=n.1.梅雨
가슴.1=n.1.(衣服的胸前部分)胸襟
가슴.2=n.2.心情, 感受
불안.1=n.1.佛顏。佛面。善面。慈面。,死者之面
밑면=n.數學:地,底面
십년감수=n.十年減壽
십년공부=n.十年寒窗,十年工夫
아미타불=n.阿彌陀佛
맏형수=n.大嫂,長嫂
작정=n.作定,決定,打算
전우=n.戰友
정각=n.整點。(用在表示時刻的詞後面)表示幾點整
회장.1=n.1.回章,傳閱文章
회장.2=n.2.回裝,飾邊。鑲邊
회장.4=n.4.回腸
전람회장=n.展覽會場
회장절개술=n.回腸切開術(英語：ileotomy)
안과의=n.眼科醫生
안과기기=n.眼科儀器
안과진단기=n.眼科診斷儀
독가스=n.毒瓦斯,毒氣
도시가스=n.城市煤氣
배기가스=n.排出的廢氣。尾氣
천연가스=n.天然氣
연탄가스=n.煤氣
탄산가스=n.二氧化碳
가스강관=n.煤氣鋼管
가스난로=n.燃氣爐
가스노즐=n.瓦斯噴嘴
가스랜턴=n.煤氣燈
시차.1=n.1.視差
지평 시차=n.地平視差
가늠=n.估計。估摸。掂量。分辨。
가늠.1=n.1.瞄準
상황.1=n.1.商況,行銷狀況。
짐작.1=n.1.猜。估計。估量。估摸。推測。預料。
채식주의자=n.素食主義者
민박=n.民宿,家庭旅館,民泊
기술.2=n.2.本事。技巧。手腕。手藝。
시인.1=n.1.是認,承認
정전.1=n.1.停戰,停火
정전.2=n.2.征戰
정전.3=n.3.正殿
정전도료=n.靜電塗料
단수=n.斷水,停水
할인혜택=n.折價優惠
공제해택=n.抵扣優惠
고객 혜택=n.客戶優惠
제공.1=n.1.祭供
공제=n.扣除,免除,控除
공제.1=n.1.共濟
공제.2=n.2.불교空諦。(三諦之一，萬物皆空的道理)
조식.1=n.1.早食,提早吃飯
조식.2=n.2.粗食。粗茶淡飯。
조식부페=n.自助早餐
조식포함=n.含早餐
이용시=n.利用時
솜병아리=n.(剛孵出的)雛雞
병아리 오줌=n.糊塗蟲
빗면=n.斜面
빗.1=n.1.[首碼] 斜。歪。偏。錯。
빗솔=n.梳子刷
도구.1=n.1.賭具
도구.2=n.2.工具,手段
도구.3=n.3.舞臺道具
빗꽂이=n.[농업] (插植)斜插。
가는빗=n.薄梳
빗반자=n.斜板
굵은 빗=n.厚梳
눈썹용빗=n.眉刷
정전.4=n.4.靜電
화장용머릿빗=n.化妝用梳。
전열발생머릿빗=n.電熱梳。
주체=n.主體외부 세계나 현실 등을 인식하고 체험하며 그것에 작용을 가하는 존재
주체.1=n.1.處置。擔當。處理。承受。
주체.2=n.2.抑制。控制。支撐。
주체.3=n.3.酒滯。酒積
몸주체=n.打扮。裝束。舉止。
옥상가옥=n.屋上架屋。疊床架屋。
옥상공원=n.[관광지] 屋頂公園
옥상 방수=n.屋頂防水
옥상 정원=n.[건축] (西式建築)屋頂花園。
옥상배풍기=n.屋頂排風機
옥상소화기=n.屋頂滅火器
옥상안테나=n.屋頂天線。
옥상통풍기=n.屋頂通風機。
옥상 인조잔디=n.屋頂人造草坪。
부서.1=n.1.[법률] (總理和國務委員)共同簽署。
집행부서=n.執行部門
배포=n.分發。發送。發行,配布
배포.1=n.1.胸懷。心志。膽識。骨氣
패포.2=n.2.想法。用心。主意。心計。
가늠값=n.平價 parity
안빈=n.安貧
빈칸=n.空房間。空地方。空格。
빈주먹=n.空手。白手。赤手空拳。
빈창자=n.空肚子。饑腸
레드 빈=n.紅豆
커피빈=n.咖啡豆
젤리빈=n.軟心豆粒糖。軟心豆腐糖
빈과록=n.蘋科綠。(陶瓷釉)
남짓=n.多,餘
거리.3=n.3.街。街道。街頭。街市。大街。
일정.1=n.1.一定
어지럼=n.暈眩
눈앞.1=n.1.眉睫。就要。即將。
정신.4=n.4.精神
정신.5=n.5.精神, 靈魂
정신.6=n.精神, 信仰
창공=n.蒼空,天空,藍天
식칼=n.食刀,菜刀
대장간=n.鐵匠舖
경진=n.競進,產品品評
경진.1=n.1.輕震
경진.2=n.2.庚辰。(六十甲子之一)
대홰=n.大會,大賽
예선.1=n.1.拖船
최종심=n.最終審
서른벌=n.30件
슈트=n.suit,套裝
재단=n.剪裁
바느질=n.縫製
중점=n.重點
실루엣=n.輪廓,sihouette
공상=n.空想,幻想
이장=n.裡長，村長
주력=n.主力
매뉴얼=n.便覽。指南。簡明手冊
접속=n.連結。點擊。訪問。
간고등어=n.鹽(漬)鮐魚。鹽(漬)鯖魚
간고등어구이=n.烤鯖魚
간고등어백반=n.烤鯖魚家常套餐
규모.1=n.1.有計劃性
사물.2=n.2.四物, 四物戲的樂器。指用於農樂的小鑼、鑼、長鼓、鼓等四種打擊樂器
사물.3=n.3.死物。(死去的動植物)
사물.4=n.4.廢物。廢品。
사물.5=n.5.賜物
상장=n.獎狀
상장.1=n.1.喪章。黑紗
상장.2=n.2.上場,上市
상장.3=n.3.喪杖。哭喪棒。
사장.1=n.1.寫場,攝影棚,照相館
사장.2=n.2.詞章。(指詩歌和文章，朝鮮時期相對經學的名稱)
상장.4=n.4.赦狀,赦免狀
사장.5=n.5.紗帳
사장.6=n.6.師長。(老師和長輩)
사장.7=n.7.查丈, 親家大人
사장.8=n.8.社葬,公司葬。(以公司名義辦的葬禮)
사장.9=n.9.私藏
사장.10=n.10.死藏,積壓。封藏。深藏。擱置不用。
사장.11=n.11.司長。(大韓帝國時期，政府各部屬下各司的主管)
기사장=n.技士長,總工程師 chief engineer
동사장=n.董事長
모래사장=n.沙灘,沙場
사장서리=n.社長庶理,代總經理 acting manager
기사.1=n.1.記事,(報紙上的)消息, 報導
기사.2=n.2.技士。(韓國技術資格等級)
기사.3=n.3.棋士/碁士
기사.4=n.4.騎士
기사.5=n.5.幾死,瀕死。臨死
기사.6=n.6.技師,工程師
기사.7=n.己巳。(六十甲子的第六)
톱기사=n.(報紙的)頭條。top記事
머리기사=n.(報刊)頭版頭條
기사광고=n.報導式廣告(載明商品用途、功能等，以報導體撰就)
기사모자=n.騎手帽
기사점퍼=n.騎士夾克
특정 기사=n.獨家新聞,特種記事
바로가기=n.快捷
여친=n.女朋友
산림=n.山林
전략=n.戰略
전략적=n.有戰略意義的
가스용접강관=n.氣焊鋼管
일종.1=n.1.一種,一類
까만빛=n.黑色
수선=n.修繕,修理, 修補
수선.1=n.1.水仙
수선.2=n.2.繡扇
수선.3=n.3.手選
수선.4=n.吵鬧。喧鬧。鬧騰。咋呼。貧嘴。饒舌。
주기=n.主氣,元氣
주기.1=n.1.周忌･週忌
주기.2=n.2.酒氣
주기.3=n.3.酒器
주기.4=n.4.週期
배즙=n.梨汁
배측=n.背部的，背上的(英語：dorsal)
배앓이=n.腹痛
배쪽의=n.腹部的(英語：ventral)
배로코트=n.嬰兒棉斗篷
배붙이기=n.棉絲混紡織品.疙瘩綢
깐=n.看來。以為
깐.1=n.1.(常用以“깐으로”形式)看。考慮到
깐풍기=n.식품용어幹烹雞.一種中國菜
깜빡이=n.(汽車)轉向燈
1깜빡이=n.1.<전기> 光标。
물질.1=n.1.物體
물질.2=n.2.財物
물질.3=n.3.財務
물질.4=n.4.(哲學)物質
테이프.1=n.1.(田徑比賽上的)終點線
테이프.2=n.2.磁帶
면테이프=n.棉織帶。棉布膠帶。
감응 테이프=n.感應膠帶。
고무테이프=n.膠帶
매직티이프=n.搭扣帶。尼龍帶扣。尼龍粘鏈。
채.2=n.2.[의존명사] 台,條,(生參)百斤
송금어음=n.匯款單
송금선불=n.預付匯款 advance remittance
단순송금=n.簡單匯款 simple remittance
할=n.[의존명사] 成。
거의.2=n.2.舉義
끈기.1=n.1.粘勁兒, 筋道
맨.2=n.2.[首碼] 淨。光。赤。空
원맨쇼=n.獨角戲。單獨表演。one-man show
원맨쇼.1=n.1.(諷刺)獨角戲。(獨斷專行)
맨다리=n.裸腿
예스맨=n.唯唯喏喏的人。唯命是從的人.yes man
식스 맨=n.[체육학] (籃球)第六球員
샐러린맨=n.工薪階層。 (salaried man )
목감기=n.咽喉腫大性感冒
상항=n.上相,上面項目。前項
상항.1=n.1.商港
동적 형태=n.動態
평범=n.平凡
화상=n.畫商
1화상=n.1.華商,華僑商人
화상.2=n.2.和尚
화상.3=n.3.[식물] 花托,花床
화상.4=n.4.火傷
화상.5=n.5.(鍋爐的)爐膛
은방울=n.銀鈴
대기.1=n.1.待機,等待, 等候, 待命
대기.2=n.2.大期,預產期
대기.3=n.3.大器,祭器
일기.1=n.1.一期
일기.2=n.2.一生。享年
일기.3=n.3.日氣，天氣
일기.4=n.4.一技
디딤판=n.腳踏板
수압=n.水壓
버퍼=n.緩衝器buffer
국어사전=n.國語字典
우체=n.郵遞,郵件
우체국 택배=n.郵局快遞
유체국사거리=n.郵局十字路口
퍼세트=n.%,百分比(百分之－)
백 퍼센트=n.百分之百
지방.1=n.1.地方,地區
지방.2=n.2.紙牌位
마법사=n.魔法師
마법의 핏=n.魔法的裝扮
요술=n.妖術。魔術。戲法。사람의 능력을 뛰어넘는 이상한 힘으로 신기한 일을 하는 기술
요술거울=n.哈哈鏡
요술 팬츠=n.魔術褲。
신경.1=n.1.[종교] (基督教、天主教)信經
후신경=n.嗅神經
신경의과=n.神經外科
어금니=n.臼齒
허세=n.虛勢.虛張聲勢
영리=n.營利。謀利。
티.1=n.1.樣子。神色。勁兒。氣
동참=n.參與。參加。加盟。
경위=n.原委
경위.1=n.1.經緯。“경위도(經緯度)”“경위선(經緯線)”的略語。
경위.2=n.2.警衛。(韓國警銜之一，在警監之下，員警之上)
경위.3=n.3.頸圍
경위.4=n.4.涇渭。是非。事理
경위의=n.經緯儀
성문=n.城門
성문.1=n.1.聲紋
성문.2=n.2.成文
웅변=n.雄辯。(演講、講話、辯論)
웅변.1=n.1.雄辯。(有說服力)
웅변대회=n.演講比賽
지방정부=n.地方政府
농담.1=n.1.濃淡
고체=n.交替。替換。更換。更替
자치구=n.自治區
지방자치=n.地方自治
친근감=n.親近感。親密感
요거트=n.優格
파우더=n.powder,粉,香粉
안건=n.案件
친척집=n.親戚家
말씨=n.口吻,腔調,口音
자살골=n.[체육학] (球類比賽誤進自家球門)烏龍球。自殺goal
분신자살=n.自焚
동반자살=n.結伴自殺。一起自殺。集體自殺
자살 교사죄=n.[법률] 教唆自殺罪。
자살 방조죄=n.[법률] 幫助自殺罪。
구성품=n.部件
구성작가=n.策劃人。(策劃電視節目並寫節目內容的人)
치명타=n.致命的打擊。
흔감=n.欣然之感。
소위.2=n.2.少尉
흰가운=n.白罩衣
비치가운=n.beach gown.海濱長衫
랩 가운=n.交叉型浴袍
샤워가운=n.浴袍
수술가운=n.手術服
위사가원=n.醫生服
고가차=n.高架車
가차=n.假借,暫借
현대중공업=n.現代重工業(現代重工業株式會社)
현대오일뱅크=n.現代石油公司
국립현대미술관=n.國立現代美術館
국립고궁박물관=n.國立古宮博物館
고궁.1=n.1.固窮,甘於貧窮
북부파출소=n.北部派出所
아치=n.理致,道理, 法則, 原理
곱창전골=n.牛腸火鍋
갈비곱창=n.排骨牛腸
곱창골목=n.牛腸街
곱창구이=n.烤肥腸
곱창볶음=n.辣炒肥腸
닮은꼴=n.相似型
지간=n.枝幹,肢幹
지간.1=n.1.趾間
성미=n.性味,性子,脾氣,性格
성미.1=n.1.誠米,祈禱米
이제.1=n.1.裏題.扉頁書名
인공 행성=n.人造衛星,人造行星
팔대 행성=n.八大行星
지구형 행성=n.地球型行星,即八大行星中的水星、金星、地球、火星
행성 박스 프린트=n.行星箱型印花
공연.1=n.1.合演。參演。同台演出。
순회공연=n.巡迴演出
공연마당=n.表演廣場
공연장소=n.演出地點
공연 관람권=n.演出門票
정기공연안내=n.定期演出指南
방향.1=n.1.芳香
방향.2=n.方響,[음악] 編磬。一種古樂器
시설.1=n.1.柿雪
증기선=n.蒸氣船
대각선=n.對角線
제로=n.zero.零,零分
랜덤=n.隨機，random
우선멈춤=n.(行駛中的汽車在斑馬線前)暫停
잠깐 멈춤 명령=n.[컴퓨터] 暫停指令 (pause instruction)
무작위=n.無作為,隨意。任意。隨機
짜리=n.(用於錢的金額數後)表示錢的面額或商品的單價
데이지=n.雛菊,黛西
칩앤데일=n.奇奇和蒂蒂
곰돌이 부=n.小熊維尼
도날드=n.唐老鴨
미키=n.米奇
미나=n.米妮
구피=n.狗皮,高飛狗
레벨=n.level,水準。水準。標準
크리스토퍼=n.克裡斯托夫(Christophe)
로빈후드=n.羅賓漢(Robin Hood)
풍선=n.風扇, [농업] 風車。
풍선.1=n.1.風船,氣球
티거=n.跳跳虎
스티치=n.stitch (西方縫紉)針法。縫法
스티치.1=n.1.史迪奇
강직=n.[의학] 強直
강직.1=n.1.降職。降級
충신=n.忠信。忠誠和信義。忠義。
충신.1=n.1.忠臣
치아발육기=n.磨牙棒
발육기=n.發育期
인도.1=n.1.印度
까르푸=n.기업명] 家乐福(Carrefour,世界著名连锁店之一)。
산타클로스=n.聖誕老人
배지=n.badge.徽章。證章。紀念章。像章。肩章。
환절기=n.換季期,季節交替之間
구분상가=n.區分商街,樓層分類購物中心 floor sorting shopping center
구분화물=n.分類貨物 sorting cargo
신고구분=n.區別申報
옥석구분=n.玉石俱焚
직종구분=n.工種分級 job classification
구분 문자=n.[컴퓨터] 定界符,分隔符號 (delimiter)
계절 구분=n.區分季節
남녀 구분=n.區分男女
산업별구분=n.按類別區分
지역별구분=n.地域劃分
소득계급구분=n.收入分等 bracket所得階級區分
일반손익구분=n.[경제] 一般損益區分
구분손익계산서=n.分部損益表 sectional income statement
영업외손익구분=n.區分營業外損益
자본거래와 손익거래구분의 원칙=n.資本交易和收益性交易的劃分原則
연구.1=n.1.[체육학] 軟球
연구.2=n.2.[문학] 聯句。
과업연구=n.課題研究 task study
사간연구=n.事例研究 event study
연구개발=n.研究開發 research and development
연구수당=n.研究津貼 research allowance
실업=n.失業,實業
실업보상=n.失業補助金 unemployment compensation
위장실업=n.潛在失業
투명=n.透明
투명백=n.透明袋
투명 끈=n.透明帶
투명 컵=n.透明杯
눈보라=n.風雪,暴風雪
특정보험=n.特定險 specific insurance
특정요율=n.特定收費率 special rate
투명 케이스=n.透明保護殼
특정운임=n.特定運費，例外運費 exceptional rate
특정자금=n.專款,專用資本 specific capital
투명유약=n.透明釉
투명 델보=n.透明包
튜명 매트=n.透明墊
투명 보틀=n.透明水瓶
투명 봉투=n.透明袋
투명 뿔테=n.透明角質框
신세.2=n.2.麻煩；(得到的)關照。다른 사람에게 받은 도움이나, 다른 사람에게 끼친 폐.
리무진=n.大型豪華轎車
꾸지람=n.指責。責備。訓斥
점퍼=n.夾克,jumper
롱 점퍼=n.長夾克
질적 향상=n.品質提高 qualitative improvement.改善
이미지향상=n.(廣告)提高形象 image up,加深印象
기대값=n.期望值 expectation
기대접근=n.預期決策 expectation approach
기대원가=n.預期成本 expected cost
운반.1=n.1.[지리] 搬運作用
경감=n.減輕,輕減
경감.1=n.1.(對罪人)從輕發落,輕勘
경감.2=n.2.警監
경감세율=n.減輕後稅率 reduced rate
조세경감=n.減稅 reduction of tax,降低租稅
딱장대.1=n.1.生硬的人。呆板的人。
속바지=n.襯褲。內褲
수선.5=n.5.[수학] 始初線。“시초선(始初線)”的舊稱。首線
잔존=n.殘存。殘留。保留
눈총=n.怒目。怒視。盯。瞪。
형부.1=n.1.刑部
베어=n.賣空 bear,空頭
다산유적지=n.茶山遺址
선사유적지=n.先史遺址
재활용 봉투=n.環保塑膠袋
폐기물 재활용=n.廢物利用
거함=n.巨艦
분리수거=n.(垃圾等)分類回收。分離收去
분리수거함=n.分類回收箱
속다짐=n.(暗自)決心。下決心。
속단=n.輕易下結論。輕率斷定.速斷
형사.1=n.1.便衣,刑事,刑警
형사범=n.刑法
사복형사=n.便衣刑警。便衣員警
형사처벌=n.[경제] 刑事處罰
형사보상=n.[법률] 刑事賠償
형사사건=n.[법률] 刑事案件。
형사소송=n.[법률] 刑事訴訟。
형사소추=n.[법률] 刑事起訴。刑事訴追
형사시효=n.[법률] 刑事時效。
형사재반=n.[법률] 刑事審判。刑事裁判
포도주잔=n.紅酒杯。葡萄酒杯
감미포도주=n.甜葡萄酒
단맛포도주=n.甜葡萄酒.감미포도주
회수=n.回收
대금회수=n.收款 collection,收取貨款,代金回收
대도회수=n.追收呆帳 recovery of bad debt,貸倒回收
지폐회수=n.紙幣回籠 recalling of bank notes
통화.1=n.1.通貨
통화회수=n.貨幣回籠 withdrawal of notes in circulation
글귀.1=n.1.語句
접촉사고=n.接觸事故。輕微交通事故, 指兩車輕微接觸性事故,追撞
접촉렌즈=n.接觸透鏡
까닭.1=n.1.心眼兒, 打算
시험지=n.試卷,考卷
난리.1=n.1.亂離,亂哄哄,騷亂
난리.2=n.2.叫苦連天
논밭=n.水田和旱田, 田地
논밭전지=n.田地。水旱田。
전지=n.田地
휴강=n.停課,休講
비밀경찰=n.秘密員警
비밀문서=n.祕密文書
비밀번호=n.密碼
고속 철도=n.高速鐵路
고속.1=n.1.古俗,古風俗
복수=n.復仇。報仇。復讐
복수.1=n.1.復水,[화학] 冷凝。(把蒸氣還原為水)
복수.2=n.2.複數
복수.3=n.3.覆水
복수.4=n.4.福數,福運。福氣。
복수.5=n.5.[의학] 腹水
뜻밖=n.意外。出乎意料。不料。以“뜻밖의、뜻밖이다”的形式使用
모양.2=n.2.樣子
모양.3=n.3.那樣, 那麼
모양.4=n.4.(表示推測)似乎, 好像
모양.5=n.5.打扮
술상=n.酒桌,酒席
형체=n.形體.形狀.模樣
셀렉트=n.選擇,select
요새.1=n.1.最近요전부터 이제까지의 가까운 얼마 동안.
파운데이션.1=n.foundation
모공=n.毛孔
자동차운전학면허학원=n.汽車駕駛學校
물자동차=n.給水車。供水車。灑水車
불자동차=n.消防車
꽃자동차=n.彩車
자동차운송=n.汽車運輸 motor transport,公路運輸
심쿵=n.心跳,怦然心動。 瞬間秒殺。
심리.1=n.1.審理
저가=n.低價,低廉
저자.1=n.1.那個人
저자.2=n.2.舊時指市場
검정=n.審定。測驗。
검정이=n.黑的。黑色的
가난뱅이=n.窮人,窮光蛋
멋.1=n.1.風範,韻味
고전.1=n.1.苦戰
고전.2=n.2.古錢
고전.3=n.3.古磚
고전.4=n.4.古篆
고전.5=n.5.古殿
고전.6=n.6.(歌手和鼓手之間)暗示。示意。
병리=n.病理
그림책=n.圖冊
돌잔치=n.週歲宴
중심.1=n.1.重心
원리=n.原理
지식.1=n.1.止息,停息
지식.2=n.2.寢息
원리.1=n.元利,本利。本息
이론.1=n.1.異論,異議
이용.2=n.2.移用,(把預算)移用。轉用
정성.1=n.1.定性
정성.2=n.2.正聲, [음악] 正調。嚴肅音樂
정성.3=n.3.[천문] 井星。(二十八星宿第二十二星座的星)
경향.1=n.1.京鄉。京城和鄉村
구김살=n.皺紋。褶皺。褶子
구김살.1=n.1.陰影。沮喪。不順利
구김=n.褶子
구김.1=n.1.陰影。沮喪
진실한 원가=n.真實成本
회다짐=n.填灰。(下葬時棺材和墳坑間填充石灰)
획인=n.劃引,(漢字)筆劃索引
청결=n.清潔。潔淨
청결차=n.清潔車
청결 공구=n.清潔工具
청결 수건=n.清潔巾
청결 용품=n.清潔用品
청결 티슈=n.清潔紙巾
진공 청결차=n.真空清潔車
미용청결크림=n.美容清潔霜
유엔 총회=n.聯合國大會,UN總會
유엔=n.聯合國,(United Nations)聯合國
총회=n.總匯。匯總
이왕.1=n.1.以往。既往。過去
우편물=n.郵件
취급실=n.收發室
취급=n.取扱,受理。處理。辦理。經營。
취급.1=n.1.視為。看做。當成
주자=n.走者,賽跑運動員。運動員
주자.1=n.1.鑄字
주자.2=n.2.候選人
주자.3=n.3.연주자(演奏者)”的略語
구두.1=n.1.口頭
발길질=n.踢,踹
화폐=n.貨幣
힘줌말=n.<언어학> 強勢語
높낮이=n.高低
완벽=n.完璧,完美。完美無缺。盡善盡美。完善
완전 커버 비비=n.完全遮瑕BB霜。
완전 커버 컨실러=n.完全遮瑕遮瑕膏
완전  포토샵 쿠션=n.完美PS氣墊。
완벽한 체형 커버=n.完美地遮蓋體型
살덩이=n.肉塊。肉團살덩어리
완수=n.頑守,堅守
완수.1=n.1.完成。履行。實現
집안 형편=n.家境
생활 형편=n.生活狀況
동사=n.動詞
동사.1=n.1.凍死
동사.2=n.2.東史
동사.3=n.3.同事
동사.4=n.4.同死,同亡
주로.1=n.1.[체육학] 跑道.走路
공급변화=n.供給變化
변화법=n.[문학] 變化法。(修詞法之一，如倒置法、引用法、對句法、反語法等)
격 변화=n.[언어학] 格的變化。變格
어미변화=n.語尾變化
기호변화=n.嗜好變動 change of luxury
답습=n.承襲。沿襲。因襲
암만.1=n.1.(無需講明的錢數或數量)多少。若干
원쑤=n.敵人
경각성=n.警覺性
경각=n.警覺。警惕
경각.1=n.1.頃刻間。旦夕。分秒
경각.2=n.2.[수학] 傾角。方向角
두둔=n.偏袒。袒護。包庇
소일=n.度日。消遣。消閒
휘지=n.[역사] 徽旨。(王世子當政時發出的命令)
어름=n.交接處。交匯處。匯合處
어름.1=n.1.正中間兒
어름.2=n.2.左右
어름.3=n.3.一帶
핫라인=n.hotline,熱線
귀걸이=n.耳環
옷걸이=n.衣架
걸이=n.掛在……上
팔걸이=n.(椅子)靠手。扶手
팔걸이.1=n.1.(摔跤，用手)勾腿
팔걸이.2=n.2.(游泳)交替滑水
귀마개=n.耳塞,耳包
공부 귀마개=n.學習用耳塞
줄어든 꼴=n.省略語
마개=n.塞子。(瓶)塞兒。蓋兒。栓。
가리개=n.擋板。屏風
눈가리개=n.眼罩
각가지=n.各種。各樣。各色。各類
급료=n.工資。工錢。薪水
인상.1=n.1.鱗狀
인상.2=n.2.[체육학] (舉重)抓舉。
인상.3=n.3.相貌
트러블=n.trouble, 不和。糾紛。麻煩
찰나=n.剎那
거위=n.[동물] 鵝，蛔蟲
거위털=n.鵝毛
거위 알=n.鵝蛋
거뉘걸음=n.鵝步。鵝行鴨步
피부 가꾸기=n.美膚
압수=n.押收,[법률] 沒收
압수물품=n.押收物品,沒收物品 confiscated cargo,扣押物品
세관압수=n.海關扣留
압수재산=n.扣押財產
숙환=n.宿患,宿疾,老病
지병=n.持病,老病。痼疾。頑疾
체육시설물=n.體育設施
공장내부시설물=n.[경제] 廠內設施
구기운동장 시설물=n.球類運動場設施
바닥재=n.地板材
줄거리.1=n.1.(蔬菜)莖。梗。秧。
연극.1=n.1.把戲
내용.1=n.1.耐用
소설.1=n.1.小雪
소설.2=n.2.昭雪。平反
개략적=n.概略的。大致的
내지.1=n.1.內地
내지.2=n.2.(君主的)內旨。密旨。
중요.1=n.1.中夭。英年早逝。
중요.2=n.2.飛來之禍。意外之災
중요.3=n.3.主要
꽃게=n.花蟹
무침=n.拌菜
굴=n.牡蠣
굴.1=n.1.窟。洞。洞
굴.2=n.2.隧道。礦井
굴.3=n.3.窩。穴。巢穴
뚝배기=n.砂鍋
회무침=n.涼拌生魚片
굴무침=n.辣味涼拌牡蠣
깻잎무침=n.涼拌紫蘇葉
숙주나물=n.綠豆芽,綠豆芽菜
숙주.1=n.1.宿主,寄主
숙주.2=n.2.熟絲綢
숙주 식물=n.[식물] 宿主植物。寄主植物
중간 숙주=n.[동물] (寄生蟲的)中間宿主。
차돌=n.石英。白石。
차돌.1=n.1.(比喻結實而精明的人)鐵蛋
차돌숙주철판덮밥=n.[음식명] 鐵板牛胸肉綠豆芽蓋飯
철판.1=n.1.凸板
더덕=n.[식물] (Codonopsis lanceolata)沙蔘。
북어=n.北魚,幹明太魚
봄동무침=n.涼拌春菜
전어=n.鰶魚
제육=n.豬肉
족발=n.豬蹄,醬豬蹄
돼지족발=n.豬蹄
참굴=n.長牡蠣
한치회=n.小魷魚生魚片
한치무침=n.涼拌小魷魚
해초=n.海草
해초무침=n.醋拌海菜
홍어=n.斑鰩
꼬막=n.[동물] (Tegillarca granosa)泥蚶
산채=n.山菜
감재미무침=n.涼拌鰩魚
골뱅이=n.[동물] 螺,[컴퓨터] “@”的俗稱
다슬기=n.鍋螺
돌나물=n.[식물] (Sedum sarmentosum)佛甲草。垂盆草。
메밀=n.蕎麥
서타벅스=n.星巴客
제품.1=n.1.製造。出品
방부제=n.防腐劑
속살=n.(被衣服掩著的)肌膚
묵=n.涼粉
모둠묵무침=n.拌涼粉拼盤
복.2=n.2.[동물] 豚魚。魨魚
복.4=n.4.[동물] 蹼。腳蹼。
복껍질무침=n.涼拌河豚皮
북어포무침=n.涼拌明太魚乾
새조개=n.鳥蛤
청포=n.涼粉.清泡
청포.1=n.1.青袍。青色道袍
청포.2=n.2.青布。藍布
청포묵=n.綠豆涼粉
청포묵전=n.綠豆涼粉煎餅
편이=n.出版者
편의.1=n.1.服務
편답=n.遍遊。踏遍
편두=n.[식물] (Dolichos lablab)扁豆
편일=n.片日,單日
시외편=n.丈夫的外祖父家
오른편=n.右邊,右方오른쪽
철도편=n.利用鐵路,鐵道便
항공편=n.坐飛機,航空便
보통편=n.普通郵件 ordinary postal matter,普通便
선착편=n.先著手。先動手。首先,先著鞭
선착편.1=n.1.立首功
분리편=n.分離，隔離(英語：sequestration)
세절편=n.薄層切片(英語：thin section)
알송편=n.[식품용어] 月牙煎蛋
옥난편=n.玉蘭片
자강편=n.磁鋼片
정기편=n.航班。班機,定期便
주옥편=n.[문학] 珠璣之作。名篇,珠玉篇
편광편=n.偏振片
흑편두=n.黑扁豆
기초 편=n.基礎篇
마찰 편=n.摩擦片
얇은 편=n.薄片
맞은편짝=n.對手
대조=n.對照。對比。比較。
코뼈=n.鼻骨
턱뼈=n.[의학] 頜骨。下巴骨
최대치=n.最大值
갈비뼈=n.肋骨。排骨。
송적=n.送籍，轉戶口。遷戶口
콩나물국=n.豆芽湯
피꼬막무침=n.涼拌血蚶
홍어회=n.生拌斑鰩
흑염소=n.黑山羊
가오리=n.[동물] 鰩。(鰩科魚的統稱)
나란히고래=n.[건축] 並列炕洞
옛것=n.故,舊
주제도=n.主題圖
다감=n.多情善感。
췌장=n.[생물] 胰臟。胰腺
낭종=n.囊腫
수선.6=n.6.[수학] 垂線
수선면장=n.引水員證書 pilot licens
설비수선=n.設備維修
실크=n.蠶絲。真絲。絲綢。綢緞silk
로드=n.整船貨 load
제의.1=n.1.題意
최토제의=n.[의학] 催吐的.英語：emetic
구창=n.口瘡
시집식구=n.婆家人
점자책=n.盲文書
점자 별독=n.盲人磚
광장.1=n.1.用作‘∼(의) 광장’的結構表示很多人一起做某事的場所或機會
제대=n.退伍,退役,復員
리포트=n.report,報告,研究報告,報導,通訊
황학루=n.黃鶴樓
색상=n.色相,顏色
탈선=n.脫線,(火車、電車等)脫軌
탈선.1=n.1.(語言、行為等)越軌, 出格
필통 케이스=n.鉛筆盒
필통 파우치=n.鉛筆袋
타박=n.責怪。指責。指摘。挑剔。賴
대쪽=n.(比喻性格、氣節)剛直。剛正不阿
대쪽.1=n.1.竹片。篾片
잔업=n.加班。加班加點，殘業
잔업시간=n.殘業時間,加班工時
무더기=n.堆
원격=n.遠程
가납사니=n.貧嘴,長舌婦
가납관세=n.暫交關稅 deposited duty
양주시=n.揚州市
광적면=n.廣積面
용법=n.用法
전부.2=n.[역사] 戰斧
해도=n.海島,海圖
설피=n.雪鞋套
밑단=n.下擺
밑단 술=n.底端流蘇
밑단 통=n.下擺寬度
밑단 꼬임=n.底端編織
자제.1=n.1.自製,自作
자제.2=n.2.子弟,令郎,令公子
물주전자=n.水壺
술 주전자=n.酒壺
디스크=n.唱片。略語:딛다.
오열=n.嗚咽
삼분오열=n.三分五裂.四分五裂
갯벌습지=n.灘塗濕地
장담=n.狀談,滿有把握,保證,肯定
장담.1=n.1.誇口.說大話
소매길이=n.袖長
밑위길이=n.褲管長
초점길이=n.焦距
길이조절=n.長短調節
가공=n.加工
가공.1=n.1.(淩空)架設。架空
가공.2=n.2.虛假。虛構。假想。
가만 눈동자=n.黑眼珠
날갯짓=n.振翅
심기=n.心氣。心情。心緒。
고수=n.高手
고수.1=n.1.鼓手
고수.2=n.2.固守。堅守。堅持。捍衛。
고수.3=n.3.高夀。長壽
세상.1=n.1.(自己)(能夠隨心所欲的)時間, 場所, 環境
기체=n.氣體
기체.1=n.1.(機器、飛機)機身
순수출=n.淨出口 net export value
현상.1=n.1.顯影, 洗相片
현상.2=n.2.懸賞。有獎
현상.3=n.3.現狀；現況。
푄 현상=n.熱風現象。 (fohin (독)現象)
값어치=n.價值.值.價
거스름=n.找頭。零頭。找(的)錢
거스름돈=n.找頭, 找錢, 找回的錢
단오절=n.端午節
헛소문=n.謠言。謠傳。風聞。風言風語。근거 없이 떠도는 소문
일반성=n.一般性
문고리=n.門環。門鼻兒。
사슬문고리=n.鏈式門環
세로형 문고리=n.立式門鉤
미닫이용 문고리=n.移門把手
장작=n.劈柴。木柴。柈子。
위해=n.危害
통.1=n.1.(衣服)肥瘦。腰圍。褲腿兒
통.2=n.2.(腰、腿等)粗細
통.3=n.3.度量。膽識
통.4=n.4.礦脈的寬度
호흡기관세지=n.呼吸性細支氣管(英語：respiratory bronchiole)
호흡.1=n.1.默契, 協調,和諧；合拍함께 일을 하는 사람들과 조화를 이룸.또는 그 조화.
싱싱한=n.新鮮的
양상=n.狀態。樣子。形式。局面
이목=n.耳目
암운=n.暗雲,烏雲,陰雲
대폭감원=n.大裁員 axing
대폭인상=n.大幅上調 sleep raise, heavy boost
대폭삭감=n.大幅削減 sharp cut
부응=n.順應。遵從。不辜負
저작=n.朱雀。(四神之一)
규격싱위=n.(交貨與合同規定)規格不符 different specification
무역규격=n.外貿規格 type
자서=n.自序
규격매매=n.憑品級規格買賣 sales by international standard
런치타임=n.午餐時間
콧방귀=n.嗤鼻；嗤之以鼻。
마침.2=n.2.[음악] (樂曲的)終止
전념=n.專念,專心,專注
멥쌀=n.梗米
찹쌀=n.糯米
찹쌀결단=n.糯米團子
말대꾸=n.頂嘴。還嘴。回嘴。남의 말을 그대로 받아들이지 않고 그 자리에서 바로 자기의 뜻을 나타냄
말대꾸.1=n.1.回答。答理
성당.1=n.1.(中國)盛唐。(唐詩鼎盛時期)
울력성당=n.群起而攻
계산성당=n.[행정공공시설] 桂山天主教堂
헛수고=n.白辛苦,白費力
상에=n.霜花。冰花
성에.1=n.1.浮冰
성.1=n.1.姓
성.2=n.2.城,城牆
성.3=n.3.省
성.4=n.4.聖
성.5=n.5.姓
성.6=n.6.星
성.8=n.8.成
성.9=n.9.火,氣
대폭.2=n.2.(書畫)對幅
대폭완화=n.大幅放寬 substantial relaxation
대폭인하=n.大幅下調 sharp reduction
대폭허락=n.大幅下跌 big fall
대폭할인=n.[경제] 大廉價
이전.1=n.1.遷移
이전.2=n.2.(權利等)移交；過戶。
이전.3=n.3.[역사] (書)吏典。(六典之一)
이전.4=n.4.역사] 衙吏
이전.5=n.5.利錢,盈利
봉우리=n.山峰
뭇 봉우리=n.群峰
쑥=n.艾草；蒿
쑥개떡=n.[음식명] 艾草蒸糕
쑥굴국=n.[음식명] 艾草牡蠣湯
쑥 비취=n.艾翡翠
쑥버무리=n.[식품용어] 艾米粉蒸糕
바지락=n.[동물] (Ruditapes philippinarum)菲律賓蛤仔。青蛤
서로.1=n.1.彼此
서로소=n.[수학] 互質數
서로치기=n.換工互助。輪著做
근절=n.大禮；磕頭跪拜
세력=n.勢力
양편=n.兩邊,雙方
우세=n.優勢,上風
우세.1=n.1.被人恥笑。丟人。“남우세”的略語
범법=n.犯法,違法
범법 사안=n.違法案件
범법 행위=n.違法行為
생각.1=n.1.想法,想像
생각.2=n.2.想法,意圖,打算
잘.1=n.1.貂皮
부분 비침=n.局部會透
신기록=n.新紀錄
모습.1=n.1.身影,影子
공모전=n.作品徵集大賽；大獎賽。公募展
미술공모전=n.徵集美術展
공모.1=n.1.共謀,同謀
총력=n.總力
참신=n.參神
참신.1=n.1.讒臣
오솔길=n.小道
흥부=n.興夫
구박=n.驅迫,刁難；折磨。
얕은꾀=n.小把戲。小計。小聰明1.shallow resources 2.superficial craftiness
숨통=n.喉管；咽喉
빚 독촉=n.催帳
열중=n.熱衷,集中精力
입굼통지=n.來款通知 notice of money received
예금.1=n.1.存款；儲蓄
은행.1=n.1.銀杏果
단정=n.斷定。判斷。確定
해이=n.鬆懈。鬆弛。鬆勁。涣散정신 상태나 태도 따위가 긴장이 풀어져서 느슨해짐
자술서=n.自述書
자술=n.自述
도리=n.道理,方法；辦法
도리.1=n.1.本分；人道
도리.2=n.2.桃李,(被人推薦的)賢人
도리.3=n.3.[건축] 檁子。桁條
직장.1=n.1.工頭。領班,職長
직장.2=n.2.直腸
심보=n.心眼兒。心思。心術。居心。
잡념=n.雜念；胡思亂想。
이만저만=n.一般；普通。主要和“아니다”等否定詞搭配使
독수리=n.禿鷹
요정=n.妖精,精靈
요정.1=n.1.了結。結束。解決,了定
요정.2=n.2.料亭。(日帝統治時期興起的有色情服務的豪華餐館，妓院的變型)
요정.3=n.3.[의학] 尿精
이해.1=n.1.理解。諒解。體諒。
이해.2=n.2.那年,今年
전달.1=n.1.前一個月。上月。上一個月
전달.2=n.2.過去的月份
매개=n.媒介
매개.1=n.1.走勢。形勢。趨勢
타이트=n.緊身
네크라인=n.領口。領口線,neckline
오래.1=n.1.街坊。里弄
계속.1=n.1.持續；延續
채.5=n.5.切絲；絲
채.6=n.6.棟；套
채.7=n.7.菜
채.8=n.8.(轎)杆。杠
채.9=n.9.枝條
채.10=n.10.槌
채.11=n.11.表示細長之物
채.12=n.12.表示長度
옆길.2=n.2.旁岔兒。(做)手腳。
구격=n.具格,配得上的。相配。般配。
주의력=n.注意力
옷차림새=n.裝束。衣著。著裝。
볼링용품=n.保齡球用品
실내등=n.室內燈
장어탕=n.鰻魚湯
상아탑=n.象牙塔
녹=n.綠,銹
녹.1=n.1.祿
일시적인=n.臨時的
본격=n.正式。用於一些名詞前面
점적=n.滴水, [화학] 滴定
점적관수=n.滴管
덜께기=n.老雄雉。老雄野雞。
욕심꾸러기=n.貪心鬼
올라운더=n.多面手。多才多藝。all-rounder
싹.1=n.1.苗頭。徵兆。兆頭。希望
풀.1=n.1.車場,泳池,pool
풀.2=n.2.糨糊。糨子。膠水。
볼풀=n.球坑
풀등=n.(江中)草洲
풀코스=n.套餐,full course, (馬拉松)全程
마른풀=n.乾草
풀뿌리=n.草根
풀계산=n.集合計算 pool account
풀덤불=n.草叢
풀슬립=n.長襯裙
축.2=n.2.軸
축.3=n.3.縮
떨기=n.草叢。花叢。
나무떨기=n.灌木叢。樹叢
하품.1=n.1.下品
딸꾹질=n.打嗝。嗝氣。
곬=n.道路。方向
재기=n.才器。(指才能和器量，也指有才的人)
재기.1=n.1.才氣
재기.2=n.2.再起,重振；東山再起
집재기=n.集材機
두드러기=n.風疹
근로일=n.勞動日 working day
연장근로=n.加班 overtime
근로의욕=n.勞動熱情 will to work
근로공제=n.勞動所得抵免 earned income exemption
다정 다한=n.既愛又恨
동글이=n.圓的
팽이=n.陀螺
잔심부름=n.打雜的活兒；跑腿活兒。
손심부름=n.身邊侍候。跑腿
안팎심부름=n.(裡外)差事。跑腿兒
바깥심부름=n.跑腿
소생.1=n.1.所生。親生子女
소생법=n.[의학] 複生，回生，蘇醒(英語：resuscitation)
인공소생=n.[의학] 複生，回生，蘇醒(英語：resuscitation)
여기서=n.這裡.here
야단.2=n.2.糟糕；壞事。
편입=n.編入；插入
고사=n.考查， 考試。考核。
고사.1=n.1.故事,舊事
고사.2=n.2.典故。掌故
고사.3=n.3.老規矩
고사.4=n.4.庫紗。(一種厚綢緞)
고사.5=n.5.庫舍,庫房
고사.6=n.6.祭；祭祀,告祀
고사.7=n.7.(用紅土和墨調和成的繪畫顏料)朱黑。
고사.8=n.8.古史。古代歷史
고사.9=n.9.古寺。古刹。
고사.10=n.10.舊事。往事
고사.11=n.11.叩謝
고사.12=n.12.致詞,告詞･告辭
고사.13=n.13.固辭,執意謝絕
고사.14=n.14.枯死
고사.15=n.15.高士
고사.16=n.16.高射
좁은 길=n.小路
작은 길=n.小徑
열성.3=n.3.列聖,歷代帝王
지위.1=n.1.知委,通告命令
지위.2=n.2.災禍的關頭。
방앗간=n.房；舂米坊
홍모=n.鴻毛
숙취=n.宿醉
가는 이빨 지퍼=n.細齒拉鍊
굵은 이빨 지퍼=n.粗齒拉鍊
희소식=n.喜消息,好消息；喜訊
소원.1=n.1.訴願,請求,請願
소원.2=n.2.溯源
소원.3=n.3.訴冤
소원.4=n.4.[역사] 昭媛。(朝鮮時期內命婦的女官之一，正四品)
소원.5=n.5.(研究所等帶所字單位的)工作人員
소원.6=n.6.[수학] 小圓。
소원길=n.希望路
관세소원=n.關稅申訴 petition on custom duties
평생소원=n.終身願望。夙願。
헌법 소원 심판=n.憲法訴訟審判
평가.1=n.1.平價
벗님=n.友人。好友。(多用於詩歌)
벗집=n.(鹽田的)燒鹽作
참된 벗=n.真正的朋友
낱개=n.單個
낱개초밥=n.散裝壽司
조바심=n.焦躁
불길=n.火焰；烈火
불길.1=n.1.不吉。不祥
낙관=n.落款
낙관.1=n.1.樂觀
오자=n.錯字。錯別字。誤字
실속=n.實際內容；內涵。
실속.1=n.1.實際利益
실속.2=n.2.實速
실속.3=n.3.(飛機)失速
노을=n.霞
탄환=n.彈丸,子彈
가책=n.譴責
봉분=n.墳地；堆墳。
부귀=n.富貴
부귀공명=n.富貴功名
시장.1=n.1.餓
시장.2=n.2.市葬
어시장=n.魚市場
맨 앞=n.最前邊
맨 처음=n.最初
낱말 카드=n.識字卡
낱말 풀이=n.解釋單詞
내수=n.耐水。抗水。
내수.1=n.1.內需, 國內需求
알밥=n.魚卵飯
모자람=n.不足之處。差。
장대=n.[역사] 點將台。
장대.1=n.1.長杆
질색=n.反感；討厭,窒塞
장대비=n.傾盆大雨。
원격조종=n.[의학] 遙控(英語：remote control)
원격 감지=n.遙感 (remote sensing)
원격 근무=n.遠端交換 (telecommuting)
심성=n.心性；性情。
심성.1=n.1.[천문] 心星。(心宿座的星星)
섬성간경병증=n.[의학] 心病性肝硬化(英語：cardiac cirrhosis)
입가=n.嘴邊
어안=n.魚眼。魚目
어안.1=n.1.指說話時動的舌頭
어안.2=n.2.愣；瞪大眼睛說不出話。以“어안이”的形式使用
어안 렌즈=n.[예술] (攝影)魚眼鏡頭。(廣角鏡頭中視覺最大的鏡頭)
후드=n.(雨衣等的)兜帽.(攝影)遮光罩.排風罩.hood
협상해결=n.協商解決
문제 해결=n.[컴퓨터] 修理故障 (troubleshooting)
분쟁해결기구=n.[경제] 爭端解決機構
손해 배상 청구의 해결 방안=n.賠償理算單 adjustment of claim
단속=n.管制；查處；嚴打。규칙, 법령, 명령 등을 어기지 않게 통제함.
단속.1=n.1.管教；管束。
입단속=n.守口。保密
몸단속=n.顧身。注意身體
몸단속.1=n.1.(儀錶舉止)檢點。謹慎
밀수단속=n.密輸團束,緝私 prevention of smuggling
단속운전=n.[속담] 斷續運行。間歇運行。
물가 단속=n.管制物價
과속 차랑 단속=n.管制超速運行車輛
불범 주차 단속=n.查處非法停車
단속사지동서3층석탑=n.[관광지] 斷俗寺址東西三層石塔
히터=n.(電)暖氣；(電)暖爐。heater
진학=n.進學,升學
학부=n.本科
학부.1=n.1.學府
최고 학부=n.最高學府
전 학기=n.上學期
학기 말=n.學期末
학기 초=n.學期初
편입시험=n.編入考試。
편입학생=n.插班生
자기포기=n.自暴自棄
전공.1=n.1.電工
전공.2=n.2.戰功
전공.3=n.3.前功
인종차별=n.[사회학] 種族歧視
의문문=n.疑問句
요점=n.要點,重點
주최=n.主催,主辦
주최 측=n.主辦單位。主辦方。
깍쟁이=n.吝嗇鬼。慳吝人。小摳兒。摳門兒
깍쟁이.1=n.1.機靈鬼。
전깍쟁이=n.吝嗇鬼。
포성=n.砲聲
아침고요=n.晨靜
일동일정=n.一動一靜。一舉一動
경기 일정=n.比賽日程。
결산일정=n.結算日程
얼정계획=n.日程計畫 scheduling
현위치=n.現在位置
딥스위치=n.變光開關
위치결정=n.[의학] 定位，確定位置(英語：localization)
위치잡이=n.[의학] 定位；確定…位置(英語：positioning)
대칭 위치=n.[수학] 對稱位置。
실측 위치=n.實測位置
선도=n.先導；領軍
위기.1=n.1.[의학] 胃氣。
위기.2=n.2.違期
위기관리=n.危機管理
살아생전=n.生前。在世。이 세상에 살아 있는 동안
피륙=n.布匹
악다구니=n.大罵。謾駡。
국적.1=n.1.國賊
국적법=n.國籍法
국적불명=n.國籍不明。
국적 취득=n.取得國籍
본고장=n.本地。家鄉
본고장.1=n.1.原產地。發源地
코드.1=n.1.編碼；代碼。
코드.2=n.2.慣例；共同語言
코드.3=n.3.代碼
랩코드=n.(婦女)外套。披肩
합수=n.合流。匯合
하숙=n.(在房東家)寄宿；寄宿處。
조수.3=n.3.(賽艇)槳手。
연구 조수=n.研究助手
영결=n.永訣。永別。告別
청결관장=n.清潔灌腸
청결습관=n.衛生習慣
청결구역=n.清潔區域
구강 청결 용품=n.口腔清潔用品。
미용 청결 크림=n.美容清潔霜
유아 구강 청결 티슈=n.幼兒口腔清潔濕巾
동지=n.冬至
독.1=n.1.缸；甕。
파탄=n.破綻,破裂；破產
뾰루지=n.疹,小疙瘩
사정.6=n.6.射程
내용.2=n.2.內容；內幕
부식=n.腐殖質
부식.1=n.1.(搭配主食吃的)副菜；副食
부식약=n.[의학] 腐蝕劑，苛性鹼(英語：caustic)
부식작용=n.腐蝕作用
부식 동판=n.蝕刻版。
부식 방지=n.防腐
근긴장=n.[생물] 肌肉緊張。“근육 긴장”的旧称。
경찰청=n.員警廳
선인장=n.仙人掌
경우.1=n.1.事理；道理；人道。
경우.2=n.2.耕牛
타격=n.打擊
타격.1=n.1.擊打
타격.2=n.2.(棒球等)擊球
신경성 흥분=n.神經性興奮
일전=n.日前；幾天前。以“일전에”的形式使用。
일전.1=n.1.轉一圈
일전.2=n.2.一戰
휘담=n.諱言
소요.1=n.1.需要
소요.2=n.2.閒逛。逍遙
3 소요=n.3.需要
창조성=n.創造性
의족=n.義足,假腿
기성=n.棋聖
기성.1=n.1.既成,已有；既有；現有。用於一些名詞前，作定語。
광주기성=n.[생물] 光週期性
기성도덕=n.既成道德,現行道德
기성사실=n.既成事實。
기성원가=n.已發生成本
기성 광물=n.[광물] 氣化礦石
기성 문단=n.已有文壇。
기성 문화=n.既有文化
기성 세력=n.既有勢力
기성 작가=n.[문학] 成名作家
기성 질서=n.現有秩序
기성 작용=n.氣化，氣成作用
기성 사이즈=n.現有尺碼。
서명.1=n.1.書名
서명반송=n.簽退,簽名退回 signing and returning
계약서명=n.簽約 signing
서명대리=n.代理簽字 proxy sign
서명 날인=n.[법률] 署名捺印.簽字蓋章。簽字畫押。
서명 운동=n.[사회학] 簽名運動。
자필 서명=n.親筆簽名。
전자 서명=n.[컴퓨터] 數位化簽名 (digital signature)
서명증명서=n.印簽證明書 letter of indication
스케줄 기능=n.排程功能
스케줄링=n.[컴퓨터] 調度 (scheduling)
모증권=n.主保單 master policy
탭증권=n.隨時發行證券 tap security
영상통화=n.視頻電話
영상매체=n.影像媒體
영상분석=n.[의학] 圖像分析(英語：image analysis)
요원=n.要員；重要人員。
요원.1=n.1.工作人員
요원.3=n.3.燎原
기간요원=n.基幹人員。骨幹人員。
조사요원=n.稅務員 revenue agent.調查要員
안전요원=n.保安；救生員，安全要員
감사 요원=n.審計員,監事人員
구조 요원=n.救護人員。
사무 요원=n.工作人員
전도 요원=n.前程遠大
정부 요원=n.政府要員
행정 요원=n.行政人員
사회복무요원=n.社會服務要員。
불화어음=n.美元匯票 bill in dollar
개의.3=n.3.開始討論
개와=n.蓋瓦,上瓦
개잠.1=n.1.回籠覺
미친개=n.瘋狗。狂犬
개백정=n.(屠宰狗的)屠夫。狗屠。
개백정.1=n.1.(罵粗莽人的話)混帳。
개화장=n.文明棍。拐杖.開化仗
골아개=n.[의학] 骨分離(英語：osteodiastasis)
개 사료=n.狗糧
개 인형=n.狗娃娃
개망나이=n.渾蛋。無賴
사슬=n.鏈條；鏈子。
사슬.1=n.1.{喻}枷鎖。比喻嚴重的壓迫和壓制
소경 문고리 잡듯=n.瞎子摸著門環。瞎貓碰上死耗子
홑껍데기=n.(沒有襯裡的)面子。
속껍데기=n.內殼。內皮。
알껍데기=n.蛋殼。卵殼
돼지껍데기=n.肉皮
이불 껍데기=n.被套
사탕 껍데기=n.糖紙
양념돼지껍데기=n.調味烤豬皮
날염 이불 껍데기=n.印花被面
시나몬=n.桂皮
염치=n.廉恥；羞恥
부아=n.火氣.怒火
소독제=n.消毒劑
고함.1=n.1.擊鼓呐喊。
재해=n.災害
마련.1=n.1.指計畫、打算。
지네=n.蜈蚣
수척=n.遊民，水尺
외원=n.外援
외원.1=n.1.(宮闕等的)外苑。
나머지.1=n.1.剩餘；其餘
나머지.2=n.2.太……就……。用於語尾“-ㄴ、-은、-던”後面。
등줄기=n.脊樑
동요=n.(物體)搖晃。搖動
동요.1=n.1.童謠。兒歌
동요.2=n.2.(思想、立場)動搖
여수.4=n.[천문] 女宿。(二十八宿第十星座)
외쪽여수=n.單方面借給
이완=n.緩和,放鬆,弛緩
이완의=n.[의학] 鬆弛的，鬆軟的(英語：flaccid)
근이완약=n.[의학] 肌肉鬆弛劑(英語：muscle relaxant)
무늬.1=n.1.花紋；紋樣；圖案。
심호흡=n.深呼吸
싫증=n.厭煩；厭倦
열등=n.劣等。低等
제자리.1=n.1.原位；應該在的地方
바깥.1=n.1.外
들판=n.田野
고비판=n.緊要關頭。
비판.1=n.1.批判；評判
부정적.1=n.1.消極的；負面的
지적.1=n.1.智力的；與知識有關的。
지적.2=n.2.智力；智慧；理性
지적.3=n.3.地籍
지적.4=n.4.土地面積
재간.1=n.1.辦法；能力
재간.2=n.2.再刊,再版,重印
일재간=n.手藝。才幹。才能。
다리 재간=n.腳上功夫。腳功
눈표=n.顯眼。醒目。
귀표=n.(飼養家畜的)耳標
역표=n.[천문] 曆表
집표=n.集票, 收票
표가=n.面額。面值.表價
표말=n.標樁
표사=n.漂砂。流沙
표의=n.[언어학] 表意。
표일=n.飄逸
가위표=n.叉號
겹낫표=n.[언어학] (豎排)雙引號。(即『 』)
극장표=n.戲票
단가표=n.單價符號。即“@”。
배급표=n.供應票 ration ticket
분석표=n.[경제] 分析表
비교표=n.比較表
수험표=n.受驗票,准考證
예정표=n.計畫表
인식표=n.[군사] 編號牌。認識票
일과표=n.日程表
일람표=n.一覽表；目錄；清單。
정가표=n.價簽。價目表。
출사표=n.[역사] 出師表
통계표=n.統計表
대변표=n.1.貸方票 credit note
요금표=n.1.資費表 tariff, list of charge
입금표=n.1.收款存根 receipt slip
건주표=n.1.(證券)行情表 current price list
견본표=n.1.樣品單 sample list
결산표=n.結算表 settling sheet
경제표=n.1.經濟表 economic sheet
고본표=n.1.股本票 stock
바꿈질=n.交換
세율경감=n.[경제] 降低稅率
생필품=n.生活必須品,日常用品상생활에 꼭 필요한 물품.
형성의=n.可塑的(英語：plastic)
박나물=n.[식품용어] 匏菜。
봄나물=n.春野菜
나물밥=n.菜飯。
나물죽=n.菜粥
가지나물=n.涼拌茄子
나물거리=n.做素菜的材料
감초나물=n.甘草(苗)
반짝반짝 스팽글=n.一閃一閃亮片
반짝반짝 블라우스=n.閃耀閃耀雪紡衫
반짝세일=n.限時打折
반짝스타=n.曇花一現的明星
반짝니트=n.閃亮針織衫
보석 반짝=n.寶石閃耀。
스팽글 반짝=n.亮片閃亮
반짝 아이디어=n.一閃而過的想法
반짝이는 티셔츠=n.閃亮的t恤。
반짝 구슬 포인트=n.閃亮珠子亮點
칼라 판짝 원피스=n.衣領閃耀連衣裙
금제품=n.金製品。
금제품.1=n.1.[법률] 違禁品。禁止品。
면제품=n.棉製品
다각제품=n.1.多種產品 multiple production
단조=n.[공업] 鍛造
단조.1=n.1.小調；小音階。
사소=n.[법률] 自訴。民告。私訴
촌뜨기=n.鄉下佬。鄉巴佬。
볼거리=n.看點；好看的東西。
또래=n.同齡人；輩
수바늘=n.繡花針
늘삿갓=n.蒲笠
늘자리=n.蒲草席子。蒲團
검은돌비늘=n.[광물] 黑雲母
늘푸른나물=n.[식물] 常綠樹。
파란빛=n.藍色。綠色。
욕심쟁이=n.貪心鬼
수수=n.高粱
수수팥떡=n.豆沙發糕
뇌물수수=n.行賄受賄 bribe giving and taking
수수부꾸미=n.高梁煎餅
차금수수=n.1.差額結算 clearing settling
금품수수=n.收受財物 take in the money and goods
수수소주=n.高粱燒酒。
촌지수수=n.行賄受賄 bribe giving and taking
수수 물엿=n.高粱糖稀
뇌물 수수죄=n.收受賄賂罪
유사.5=n.5.有史。
별유사=n.[역사] 別有司。(京城各坊掌管戶籍及公共事務的使役)
유사의장=n.1.類似設計 similar design
백관유사=n.朝廷百官,百官有司
유사견본=n.近似樣品 similar sample
유사물질=n.[의학] 相似物，類似物(英語：analogue)
삼국 유사=n.[문학] 三國遺事。
유사이래=n.有史以來
한바탕.1=n.1.一陣；一氣。
격전=n.激戰
희열=n.喜悅
나날=n.日子。每天。天天。
벅찬 나날=n.充實的日子
인고=n.忍受痛苦。隱忍.忍苦
나뭇잎 책갈피=n.樹葉書簽
책갈피=n.書頁間
사납다=n.凶성질이나 행동이 모질고 억세다
검탄=n.黑木炭
살아평생=n.生來。一生
쏘다.1=n.1.蟲子螫
환불.1=n.1.退回;退還
벽보=n.壁報,牆報
펌웨어=n.固件,firmware
땀 냄새 제거크림=n.除汗膏
덧없는 신생=n.短暫的人生。
이혼율=n.離婚率
하품에 딸꾹질=n.禍不單行,無巧不成書
보완=n.改進；補充完善
야말로=n.這才是；這真的是。表示強調指定的物件。加在母音結尾的名詞後面
말 상대=n.說話的對象。(跟…)談話的資格
민족적자부심=n.民族自豪感。
자부=n.慈父
자부.1=n.1.自負。自豪。自信。
자부.2=n.2.子婦。兒媳婦。
야근 수당=n.夜班費
근지수=n.[수학] 根指數
여기.1=n.1.業餘愛好。
가치.1=n.1.假牙。義齒。假齒
세간=n.傢俱
1 세간=n.1.世人。世上。社會.世間
토막=n.塊；段
토막.1=n.1.截
토막.2=n.2.一小段；一小塊兒
토막.3=n.3.地窖。地窨子
톱=n.頂級；第一。
톱.1=n.1.頭條。
내.1=n.1.小溪；溪流
내.2=n.2.味；氣味
내.3=n.3.隨意；輕易。加在一些固有詞動詞前面
사계절 내내=n.四季之內。
이혼 소송=n.離婚訴訟。
사후이혼=n.死後離婚，指最近在日本配偶死後像日本法務廳提交關於結束親戚關係的申請書，與配偶家人斷絕關係的行為
합의 이혼=n.協議離婚。
대가.1=n.1.大家。大師。巨匠。
대가.2=n.2.大家。大家族。(名門大家)
대가관계=n.對價關係 consideration
대가변제=n.1.償付 compensation
경락대가=n.拍賣成交價格 auction price
공급대가=n.[경제] 供應代價
농포형성=n.[의학] 膿皰形成(英語：pustulation)
농포편도암=n.[의학] 膿皰性扁桃體炎(英語：pustular tonsillitis)
약전=n.弱電。微電。
약전.1=n.1.[법률] 藥典。
약전.2=n.2.略傳
분투=n.奮鬥
분투노력=n.努力奮鬥
선전분투=n.英勇善戰
역전분투=n.艱苦奮鬥。
용전분투=n.英勇奮戰
보온작용=n.保溫作用。
유도작용=n.誘導作用
자극작용=n.[의학] 刺激；刺激；興奮(英語：stimulation)
주체.4=n.4.核心；中堅；主導
존재.1=n.1.存在；受到矚目的對象
현실.1=n.1.玄室
인식색=n.[동물] 認識色。(動物的標誌色之一)
모양인식=n.[의학] 圖形識別；模式識別(英語：pattern recognition)
수익인식=n.[경제] 確認收入
인식능력=n.認識能力。
도형인식=n.(電腦)識圖。
이재민=n.災民；難民,罹災民
이재민 구호 사업=n.難民救助工作
결산=n.結算
결산.1=n.1.總結；結束
백인.1=n.1.白刃。
백인백색=n.百人百色。百人百面
백주.1=n.1.白酒
백주발검=n.白晝拔劍。
공급표=n.供給表 supply schedule
공정표=n.工序圖 process chart
관세표=n.關稅表 tariff table
단체표=n.單純圖形 simplex tableau
살얼음=n.薄冰
살얼음판=n.比喻岌岌可危的狀態。
살얼음판.1=n.1.薄冰
원인 규명=n.查明原因
갖은자=n.大寫。(如“一”為“壹”，“二”為“貳”)
갖은소리=n.(各種) 廢話。
갖은소리.1=n.1.大話。空話
갖은삼표=n.[건축] 三層斗拱。
갖은색떡=n.各種彩糕。
군데군데.1=n.1.處處；到處；多處여러 곳마다.
별지 첨부=n.附上附件
별지=n.附文,附件
별지.1=n.1.另紙
별호=n.號,綽號
협조.1=n.1.協調。調和。
충실.2=n.2.(小孩子身體)結實。
충실.3=n.3.硬實
충실.4=n.4.充實
상표충실도=n.(廣告)品牌信任度 brand royalty
기분에 충실한=n.忠實於基本的。
예탁=n.事先託付
예탁.1=n.1.[경제] 存放。寄存
동일=n.同日。同一天
동일법=n.同一方法
동일.1=n.1.相同；同等
동일.2=n.2.同一個。
꾸밈=n.打扮；裝飾。
꾸밈.1=n.1.做作
헌액=n.獻額。(向紀念館等獻出名人的肖像等)
유력=n.有力。有實力。有勢力。
유력.1=n.1.有希望。熱門。呼聲很高
유력.2=n.2.遊歷。巡遊
동일노동동일임금=n.同勞同酬 equal pay for equal work
동일분석=n.(廣告)簇叢分析 cluster analysis
동일증권=n.同一保單 equal policy
가불=n.預支。預付。
봉급가불=n.預付工資 wage advance
보증금가불=n.預付保證金 advance money security
볼 이음=n.頭接球
먹=n.墨。
먹.1=n.1.墨汁
먹즙=n.墨汁
먹그림=n.[미술] 水墨畫
먹종이=n.黑色複寫紙
즐겨찾기=n.[컴퓨터] 我的最愛 (favorites)
찾기=n.[컴퓨터] 檢索 (search)
노한 표정=n.怒容
표정.1=n.1.面貌
석가=n.釋迦。(屬於古印度第二姓刹帝利的種族)
석가.1=n.1.[의학] 石瘕。(子宮淤血症狀)
석가 탠신일=n.佛誕日
순종=n.順從。聽從。
순종.1=n.1.純種
순종 말=n.純種馬
잔 받침=n.杯墊
잔주름=n.細紋；魚尾紋
잔주름 치마=n.密褶皺裙。
풀.3=n.3.氣勢
풀전략=n.(廣告)拉通推銷術(直接向消費者推介使其指名購買本公司產品的推銷手法) pull strategy
풀커버=n.四角防摔
풀협정=n.分攤承運協定 pool agreement
말대=n.卷棉杆。(紡紗用卷棉花的高粱杆)
말대.1=n.1.末代。末世
함.1=n.1.(簽名的)字。銜
함.2=n.2.函,箱子
함.3=n.3.聘禮箱。
직위=n.職位
해임=n.解任,免職어떤 직위에 있는 사람을 맡은 임무를 내놓고 물러나게 함
태도.1=n.1.儀態；態度。
방위.1=n.1.防衛；保衛；防禦。
지점.2=n.2.[건축] 支點。支撐點。
쪽.1=n.1.髻；發簪。
몸부림=n.(身體)亂動；掙扎
멈부림.1=n.1.掙扎
정렬 키=n.[컴퓨터] 排序鍵 (sort key)
정렬오류=n.[의학] 錯排(英語：misalignment)
작품.1=n.1.{喻}傑作。指是某人的作為。
물건.1=n.1.物品；東西。
상용=n.常用
상용.1=n.1.商用,商務
불가=n.不可,禁止
불가.1=n.1.佛家。佛門
불가.2=n.2.佛歌
초본=n.草本
초본.1=n.1.略本。摘要件。
초본.2=n.2.(詩文)草稿。原稿。
빈 테이프=n.空磁帶
테이프 티=n.tapet恤。
면 테이프=n.棉織帶。棉布膠帶
종이테이프=n.紙帶。膠粘紙
메탈태이프=n.金屬磁帶(metal tape)
수정테이프=n.修正帶
야관테이프=n.夜光膠帶。
양면테이프=n.兩面膠布。
데모 테이프=n.demo tape1.樣品錄音帶。
감압 테이프=n.壓敏膠帶
감열 테이프=n.熱敏膠帶。
경고 태으프=n.警示帶。警示膠帶。
내열 태이프=n.隔熱膠帶
녹화 테이프=n.錄影帶
라인 테이프=n.標線帶。
레드 테이프=n.文山會海 red tape
리본 테이프=n.蝴蝶結帶。
물결 테이프=n.波紋帶
밀봉 테이프=n.密封(膠)帶。
박스 테이프=n.封箱膠帶
반사 테이프=n.反光帶
방수 테이푸=n.防水膠帶
방식 테이프=n.防蝕帶。
방화 테이프=n.防火膠帶
벨벳 테이프=n.絲絨帶。
대꾸=n.頂嘴；回答。
야외예식장=n.露天禮堂
예식=n.慣例。例行方式。
예식.1=n.1.禮式,婚禮
엽서.1=n.1.葉序
관제엽서=n.官制明信片。
그림엽서=n.明信片。
기념엽서=n.紀念明信片
봉함엽서=n.封口明信片
우편 엽서=n.明信片
미니 엽서=n.迷你日曆
사제 엽서=n.自製明信片。
엽서 세트=n.明信片套裝
풍경 엽서=n.風景明信片
꽃 그림엽서=n.花朵圖案明信片。
엽서 디자인=n.明信片設計。
상용반신엽서=n.1.商業回信卡 business reply card
캘리그래피 엽서=n.書法明信片。
미니 엽서 4장 세트=n.迷你卡片四張套裝。
지원.1=n.1.志願；申請。
지원.2=n.2.渴望。最大願望,至願
지원.4=n.4.至冤，“지원극통(至冤極痛)”的略語。
지원.5=n.5.支院,分院
금융지원=n.1.金融支援 financial support
재정지원=n.1.財政支持 financial support
부문지원=n.部門援助 sector assistance
지원활동=n.支援活動(指企業為構築其價值鏈而進行的技術開發、財務、公關、策劃等活動) support activity
기술 지원=n.[컴퓨터] 技術支援 (technical support)
보조금지원=n.提供補貼 granting of subsidies
거의.3=n.3.大部分；基本上。
견본과 거의 같다=n.與樣品大體相符” about equal to the sample
말.1=n.1.鬥
말.2=n.2.棋子
말.3=n.3.用於一些動植物名詞之前，表示“大”。
말.4=n.4.馬
살.1=n.1.齒,骨
살.2=n.2.(賭博)籌碼。
정도.6=n.6.“정밀도(精密度)”的略語。
꼴.1=n.1.處境
꼴.2=n.2.形狀
꼴.4=n.4.草；秣草。
쇠꼴=n.牛草
볼꼴=n.(看著不順眼的)模樣。
손꼴=n.掌形。
키꼴=n.個頭
꼴호즈=n.集體農莊(前蘇聯) kolkhoz
마침꼴=n.[언어학] 終結形。
나비꼴 밸브=n.蝶形閥。
천재.1=n.1.天災
천재.2=n.2.淺才。菲才
천재.3=n.3.千載。千年。
천재교육=n.天才教育
곡.1=n.1.首；支。用於數詞後面。
곡.2=n.2.哭
두엄=n.堆肥
새끼.1=n.1.草繩
동강=n.段兒。截兒。頭兒。
양초 동강=n.洋煙截兒
동강래프팅=n.[관광지] 東江漂流,東江泛舟
동강둔치=n.[관광지] 東江岸丘
양잿물=n.燒鹼；氫氧化鈉。
잿물=n.草灰水。(舊時用來洗衣)
잿물.1=n.1.[공업] 釉子。
잿물.2=n.2.堿。燒鹼。火堿。
태세=n.態勢；措施
태세.1=n.1.氣勢；架勢
풀어쓰기=n.(韓國文字)拆開拼寫
교편=n.教鞭
교편 펜=n.鋼筆教鞭。
교편생활=n.教師生活。
양호=n.養護
양호.1=n.1.保健
대접.1=n.1.對待；待遇
대접.2=n.2.大碗；湯碗。
신원=n.來歷；身份
신원.1=n.1.申冤
사위.1=n.1.忌諱。禁忌。
사위.2=n.2.四圍。四周。
사위.3=n.3.(胎位)斜位。“사태위”的舊稱
빼드렁니=n.齙牙。
매꾸눈=n.獨眼
죽.10=n.10.(衣物、器皿)套。(一套為十件)
수사.1=n.1.數詞
노릇=n.當……。做……。職責。義務。(含貶義)
원통=n.冤枉。怨恨。
원통.1=n.1.痛惜。痛心。
원통.2=n.2.圓筒
적기=n.合適的時期。
적기.2=n.赤旗，指報危險的信號旗。
그만큼.1=n.1.那麼；那些
미약=n.媚藥
오류=n.錯誤
동작오료=n.工作差錯
우울=n.憂鬱；鬱悶。
재촉=n.催促
대어=n.[언어학] 對應詞語。(如“山水、上下、貧富”等)
급식=n.給食,供應伙食；供餐；伙食
급식시설=n.供餐設備。
급식마스크=n.供餐口罩。
학교급식제도=n.學校伙食供應制度。
임장=n.林葬
인장=n.印章,印跡
몰살=n.殺光。斬盡殺絕
몰살.1=n.1.全部死亡。
볼륨=n.音量
거두.1=n.1.巨頭。巨擘。鉅子
거두.2=n.2.舉頭。抬頭。
거두.3=n.3.(心裡無愧而光明磊落地)面對。
거두.4=n.4.(重病漸漸有了起色)好轉。
응성충=n.應聲蟲
기관.1=n.1.機關；機構。
기관.2=n.2.發動機
기관.3=n.3.器官
물리적=n.物理的
물리적.1=n.1.武力的；暴力的。
구체=n.具體
구체.1=n.1.球體
구체 명사=n.[언어학] 具體名詞
임산물 가공=n.林產品加工。
할인.1=n.1.契印。騎縫印.割引
무할인=n.無折扣 no reduction.無回扣
할인일=n.[경제] 貼現日
환할인=n.外匯貼水 discount
요실금=n.[의학] 尿失禁。遺尿。
요술톱=n.鋼絲鋸
명령.1=n.1.指令
법령=n.法令
자세.1=n.1.仗勢。倚仗，藉勢
정도.7=n.7.限度
멀리뛰기=n.跳遠
멀리보기=n.遠眺
제자리멀리뛰기=n.立定跳遠
제법.4=n.“제조법(製造法)”的略語,製法
결석.1=n.1.結石
금주=n.本周,今週
금주.1=n.1.禁酒,戒酒
진저=n.[식물] 生薑。生薑粉。
공지.1=n.1.空地
공지.2=n.2.共知,周知
콘텐츠=n.[컴퓨터] (資訊等)內容。內容物。content
별로.2=n.2.別的路
볼일.1=n.1.{婉}大便；小便。
대로.6=n.6.組成“~은 ~대로、~은 ~대로”的結構使用，表示分別、各自。
대로.7=n.7.按照；依照
독학=n.獨學,自修,自學
독학.1=n.1.篤學。專心好學。
독학.2=n.2.督學
총명=n.總名,總稱
총명.1=n.1.聰明
총명.2=n.2.(帝王)寵命。
영리.1=n.1.역사] 營吏。(朝鮮時期監營、兵營、水營的官吏)
기울기=n.[수학] 傾斜度。
경사기울기=n.梯度坡度(英語：gradient slope)
목적.1=n.1.[약학] 木賊
목적.2=n.2.牧笛。
열기.1=n.1.(眼神)熾烈
열기.2=n.2.熱情；令人激動的氣氛或場面。
열기.3=n.3.燒
파악=n.掌握；洞悉；充分瞭解。
윤기=n.光澤；光潤
딴생각=n.胡思亂想
딴생각.1=n.1.別的想法
피드=n.饋送 (feed)
공문=n.公文
공문.1=n.1.[건축] 拱門
공문.2=n.2.空門
공문.3=n.3.[생물] 孔紋。
공문.4=n.4.孔門
공문도관=n.孔紋導管
공문서류=n.公文檔案
지상공문=n.一紙空文
공문 발송=n.發送公文
교환 공문=n.交換公文
라이프 스타일=n.生活方式(市場調查用語) life style
엔터테인먼드=n.娛樂,entertainment
맞춤=n.定做
입맞춤=n.親嘴；接吻。
입맞춤.1=n.1.親吻禮；吻手禮。
무릎맞춤=n.對質。質證
십자맞춤=n.十字榫合
가운 맞춤=n.定制禮服
맞춤 각구=n.定制傢俱。
맞춤 구두=n.定做的皮鞋
맞춤 비누=n.定制香皂
맞춤 신문=n.(《韓國經濟新聞》的)電腦讀者服務網。
맞춤 제작=n.量身定做
왼쪽 자리맞춤=n.向左對齊 (left justification)
오른쪽 자리맞춤=n.向右對齊 (right justification)
맞춤 제작 스티커=n.定制貼紙。
맞춤 주문형 의류=n.定制衣服。
신구=n.新舊
추문=n.醜聞
추문.1=n.1.盤問。審問。
기회.1=n.1.空閒
차지=n.[체육학] (足球、籃球)衝撞。
차지.1=n.1.[물리] 充電
차지.2=n.2.<물리> 電荷。
차지.3=n.3.小費
차지.4=n.4.租地。租借土地。
차지.5=n.5.租借的土地
차지.6=n.6.[역사] 次知。管家
차지.7=n.7.[역사] 替主人受刑的下人
차지.8=n.8.佔有。和一些名詞或代詞搭配使用
비하=n.(地位)卑下。低下。
비하.1=n.1.貶低
무게.1=n.1.重心；分量。指重要度
무게.2=n.2.重量。指威力、影響力
무게.3=n.3.穩重
포장무게=n.包裝重量
무게중심=n.[물리] 重心
한 짝 무게=n.一邊的重量
캐리어 무게=n.旅行包重量。
그중.1=n.1.其中
끝장=n.尾聲；到頭；完。
끝장.1=n.1.{俗}完蛋。和“-이다”搭配使用。
재산.1=n.1.財產；財富
배장기=n.排障器
배짱=n.骨氣；固執
배짱.1=n.1.膽；膽量
골.1=n.1.溝；山溝。
골.2=n.2.(人際關係的)矛盾；裂痕
골.3=n.3.氣；火
골.4=n.4.(量或裁布匹、紙張、木板等的)標線
골.5=n.5.骨
관공서로.1=n.1.[행정공공시설] 官公署路
단체.1=n.1.[화학] 單質。單體。單元素物質
인사.1=n.1.禮；禮節；拜訪。
인사.2=n.2.互相介紹；互通姓名。
인사.3=n.3.人事
인사.4=n.4.人士
첫인사.5=n.5.初次問候(致意)
인사불성=n.不省人事
인사불성.1=n.1.不懂禮貌
인사치레=n.客套。裝樣
인사기록=n.人事記錄 personnel record,人事檔案
유명인사=n.有名人士
인사감사=n.人事監察 personal audit
인사비밀=n.人事機密。
인사이동=n.人事調動
재야인사=n.在野人士
지명인사=n.知名人士
개명인사=n.開明紳士
고별 인사=n.告辭
고위인사=n.高層人士
권내인사=n.圈內人士
모모 인사=n.某某人士
민주 인사=n.民主人士
상관 인사=n.有關人士。相關人士
아침 인사=n.早上問候。
야당 인사=n.在野黨人士
외부 인사=n.外部人士
인사 경질=n.人事更迭。
인사고과=n.[경제] 人事考核。
인사관리=n.[경제] 人事管理。
시작.2=n.2.詩作
환가=n.換價,(房地產)交換差價
환가.1=n.1.變現。折換現金
환가.2=n.2.換房,換家
환가.3=n.3.有病人的人家,患家
환가손=n.匯兌損失 exchange loss
환가담보=n.變現擔保 convertible security
환가환율=n.變現匯率 exchange equivalent
차원.1=n.1.層面；水準；檔次。
국가 차원=n.國家層面。
진취적인=n.進取的
게거품=n.蟹沫
게품.1=n.1.白沫
게걸음=n.蟹步。橫步
게자리=n.[천문] 蟹座
가정.4=n.4.轎夫,駕丁
가정생활=n.家庭生活
가정용품=n.家庭用品
가정주부=n.家庭主婦。
심각=n.深刻,嚴重,嚴肅
심각.1=n.1.深雕
급 심각=n.立即變沉重
감잡이=n.(男女合房時用的)床巾。
고드름=n.冰柱；冰淩吊子
돌고드름=n.[광물] 鐘乳石。石鐘乳
고드름똥=n.冰溜屎。(形如冰溜的屎)
고드름짱아찌=n.(戲言)無聊透頂的人。
씽=n.唱歌,sing
개요=n.概要
영업개요=n.營業概要
클레개요=n.索賠單 claim note
원가개요기록=n.成本匯總記錄 cost summarizing records
한국 역사 개요=n.韓國歷史概要
쿨백=n.保溫包
달리기 시합=n.賽跑
시합장=n.比賽場
국제 시합=n.國際比賽
궁술 시합=n.射箭比賽。
권투 시합=n.拳擊比賽
복식 시합=n.雙打比賽。
투우 시합=n.鬥牛比賽。
통지서=n.通知書
선정=n.煽情。性感。
선정.1=n.1.選定；遴選。
선정.2=n.2.善政；仁政。
요선정=n.[관광지] 邀仙亭
선정.3=n.3.[불교] 禪定
공장입지선정=n.[경제] 廠址選擇
배심원 선정=n.(心理學)陪審團選定。
목발=n.雙拐
겉.1=n.1.外；外面；外皮
겨드랑이=n.腋窩；咯吱窩；胳肢窩。
겨드랑이.1=n.1.腋下
대지팡이=n.竹杖
쌍지팡이=n.雙拐
수티로품=n.聚苯乙烯；泡沫塑料.styrofoam
수중 유행=n.夢遊
유행 샌들=n.流行涼鞋。
스냅백=n.頭戴棒球帽
덮개돌=n.[고고학] (石棚的)上石。
덮개 요리=n.琉璃蓋片
날짐승=n.飛禽
드래그=n.[컴퓨터] 拉。拽。drag
드래그.1=n. [물리] 阻力。
숭승장구=n.] 乘勝長驅。乘勝前進。長驅直入。
승승장구=n.乘勝長驅。乘勝前進。長驅直入。
요전=n.前些日子,前些時間
위젯=n.小部件,widget.
퍽.1=n.1.[체육학] 冰球。(指球)
불평불만=n.不平不滿。牢騷。抱怨
똥차=n.(比喻)破車。老掉牙的車。
똥차.1=n.1.糞車
현실전손=n.
둘레=n.邊。沿。周圍。四周。
둘레.1=n.1.周。圍。
너비=n.寬度。寬幅
사고뭉치=n. 惹禍精。(老是惹是生非的人)
후의=n.厚誼
후의.1=n.1.厚意。
맹장후의=n.盲腸後的(英語：retrocecal)
발작후의=n.發作後的(英語：postictal)
자궁후의=n.[의학] 子宮後的(英語：retrouterine)
폐후=n. [역사] 廢後
후건=n.[논리학] 後件。
후술=n.後述。下述。
후차=n.下次。其次。
후폐=n.後弊。後患
맥후=n.[의학] 脈候。脈象。(脈搏上顯現的病症)
물후=n.死後.歿後
후가=n.改嫁。後婚。後嫁
예사=n.常事；習以為常的事。
예사소리=n. [언어학] 平音。(輔音“ㄱ·ㄷ·ㅂ·ㅅ·ㅈ”)
예시낮춤=n.[언어학] 普通卑稱
예사높임=n.[언어학] 普通敬稱。
레벨.1=n.1.水平儀。水準儀
장례용품=n.葬禮用品。
친목회=n.聯誼會,親睦會
친목=n.友好；友誼
제정신=n.正常的精神狀態
은폐=n.隱瞞；隱匿；隱藏。隱蔽
공작=n.孔雀
공작.1=n.1.[역사] 公爵
공작.2=n.2. (事前)謀劃；(暗中)工作
공작.3=n.3.製造；製作
빈털터리=n.窮光蛋
길거리 농구=n.街頭籃球。三人制簡易籃球。
길거리 모금=n.
금사오죽=n. [식물] 金絲烏竹。
분통=n.粉盒。粉匣。粉桶
분통.1=n.1.火；怒火；氣憤。憤痛
변방=n.邊境；邊疆。
변방.1=n.1.邊防
정거장 인도=n.[경제] 火車站交貨。停車場引渡
정거장인도조건=n.
가량=n.大約；左右；上下。用於數詞後面。假量
속가량=n.估計。估摸。估量。
1주일가량=n.1周左右。
사랑니=n.智齒
때.1=n.1.垢；污垢
쇠지레=n.鐵杠子。鐵撬棍。
지레김치=n.(夏季)現醃泡菜。
개살구=n.野杏。山杏
바람.1=n.1. (線、繩)庹。
항정=n.(豬、狗)脖子
항정.1=n.1.(牛)胸脯肉。
항정.2=n.2.航程
퇴적=n.堆積
퍼즐=n. 拼圖,puzzle
승강장=n.月臺；車站。
혼시=n.渾身；全力
한끼=n.頓飯
사건일지=n.
만원.1=n.1.滿員。滿座
만원.2=n.2.[불교] 滿願。祈禱期滿
만원 버스=n.
만원사례=n. 滿員致謝。(貼在劇場門口的客套話，表示劇場已經滿員)
전내=n.殿內
전내.1=n.1.牌位。神位。
종다리=n. [동물] (Alauda arvensis)雲雀。百靈鳥。天鷚。
한편.1=n.1.不僅……而且……；一邊……一邊……。用於“-는”後面。
손녀사위=n. 孫女婿
손등 너비=n.
손등 높이=n.
손바닥뼈=n.[생물] 掌骨
손바닥 지압기=n.手掌指壓器。
성실=n.誠實；誠懇；踏實。
유학.1=n.1.儒學
유학.2=n.2.[역사] 布衣儒生。
조기유학=n.早期留學
도미 유학=n.
확인은행=n.
확인주문=n.確認訂貨
확대 컷=n.
확대회의=n.擴大會議。
인정.1=n.1.人情味
인정.2=n.2.仁政
인정.3=n.3. [역사] 宵禁鐘.人定
유발된=n.[의학] 誘導的(英語：induced)
유발수출=n.
타자=n.打字
타자.1=n.1.(棒球)擊球手.打者
타자.2=n.2.他人；別人。
함수=n.函數
함수.1=n.1.鹹水
함수.2=n.2.艦首
인간.1=n.1.刊印
강제.1=n.1.鋼製
어깨 소매길이=n.
소매길이 총장=n.袖子總長
날인=n.捺印,蓋章
기명날인=n.簽名蓋章,記名捺印
지문 날인 거부 문제=n.拒絕按手印問題。指紋捺印拒否問題
양초=n.糧草
양초.1=n.1.洋醋
양초.2=n.2.蠟燭
인사고과제도=n.[경제] 人事考核制度
고과=n.[역사] (下級向上級)申報,告課
고과.1=n.1.[역사] 考核
대오철조=n.[불교] 大徹大悟。
대오 강성=n.
버티컬=n.立式
데일리룩=n.
선생노릇=n.(當)小教員。
중노릇=n.當和尚。
나그네노릇=n.作客
세물전=n.(出租喜喪用品的)出租店。
야속=n.夠交情。冷若冰霜。冷酷。無情。
눈코=n.眼鼻
코밑=n.(表示時間、距離很近)鼻子底下。眼前。眼皮底下。
호화성=n.相容性
일억=n.一億
곧추뛰기=n. [체육학] (跳箱)直跳
현장.1=n.1.工廠
현장.2=n.2.現場。組成“~의 현장”的結構使用。
동시=n.同詩
동시.1=n.1.凍屍
동시통역=n.同聲翻譯。同聲傳譯。
동시관리=n.
동시발생=n.[의학] 同時性，同步現象；準時發生(英語：synchronia)
동시상장=n.同時上市 concurrent listing
데님=n.斜紋粗棉布。(工作服用料).牛仔
지어지처=n.止於止處。當止即止
지어지처.1=n.1.泊無定所
시기.3=n.3.試技, [체육학] (田徑)試跳、試擲等。
전.1=n.1.沿。邊緣。
전.2=n.2.氊子。
전.3=n.3.(舊時)店。店鋪。
전.4=n.4.分。(貨幣單位)
인테리어=n.室內裝修,interior
구름 접촉=n.[속담] 滾動接觸。 (rolling contact (영))
물밑 접촉=n.
접촉 감염=n.[의학] 接觸感染。
접촉 광물=n.接觸礦物
개로.1=n.1.皆勞。共勞
골이개=n.
큰개자리=n.[천문] 大犬座
술 먹은 개=n.
광고찌우개=n.
작은개자리=n.[천문] 小犬座。
전과=n.戰果
전과.1=n.1.前科,犯罪紀錄
전과.2=n.2.[교육] 全科。全課。
전과.3=n.3.轉科,轉系。
전과.4=n.4.專科。專業
전과.5=n.5.前過。過去的過錯
전과.6=n.6. 全部課程
창가.1=n.1.唱歌。甲午更張以後出現的西洋式歌曲
창가.2=n.2.娼妓家
창가병=n.瘡痂病,鏽癍病
창가 학회=n.(日本)創價學會。
주어=n.主語
말복=n.末伏,1년 중 가장 덥다고 하는, 삼복 중 마지막 날.
교모=n.校帽。
교모세포종=n.[의학] 成膠質母細胞瘤(英語：glioblastoma)
재치=n.才氣
거리낌=n.妨礙；顧忌；忌憚。
거리낌.1=n.1.顧忌；忌憚。
소원 발찌=n.
코스메틱=n.化妝品(Cosmetics)
추출=n.抽出
추출.1=n.1.[화학] 提取
추출법=n.
추출조사=n.抽查 sample survey
다단추출=n.多級抽樣 multi-stage sampling
시킨=n.
보습=n.保濕
보습.1=n.1.補習
보습.2=n.2. (皮膚)補濕。
왕래=n.往來,來往
간걸=n.懇乞,懇求
치어걸=n.啦啦隊女郎。
걸과=n.[역사] 乞科。(小科落榜的書生乞求考官試試自己的實力)
걸때=n.身材。塊頭
커버걸=n.(雜誌的)封面女郎cover girl
톡톡 원단=n.清新的面料。
침식불안=n.寢食不安。
조리 가전=n. 烹飪用家電。烹調用家電。
발급=n.發,發給
시헙지발급=n.發考試卷
울렁증=n.心悸症
복색=n.服色
난리굿=n.鬧。胡鬧。
소로치기=n. 換工互助。輪著做。
북새통=n.人群嘈雜。
고집불통=n.頑固；固執；老頑固。
닭고집=n.強驢子
닭고집.1=n.1.死強
땅고집=n.特別固執。死強。執拗。
황소고집=n. 牛脾氣。
스타벅스=n.星巴克
일가친척=n.本家親戚
인아친척=n.姻婭親戚。(姻親和族親)
뒷전=n.後面
뒷전.1=n.1.顧不上。排不上號
뒷전.2=n.2.背後。背地。
뒷전.3=n.3.船尾
시냇물=n.溪水
도중.1=n.1.道中心。路中央。
도중하차=n.中途下車。
도중하다.1=n.1.打退堂鼓。半途而廢。
견딜힘=n.耐力。抗力。抵抗力。
자신.1=n.1.自信。信心。把握
의사 소통=n.溝通思想。意思疏通
상향의사소통=n.
이중의사소통=n.
하향의사소통=n.
의사소통 장애=n.
비 언어적 의사소통=n.
절적=n.絕跡
고국땅=n.故土
고국산천=n.故國山河
비굴=n.卑躬屈膝。卑鄙。
식단=n.食譜；菜譜,食單
식단.1=n.1.煎飯團
상차림=n.擺桌；餐桌
양장차림=n.
사복 차림=n.
평복 차림=n.
나그네차림=n. 旅裝。行裝
나들이차림=n.外出裝束
옥돔상차림=n.[음식명] 鯛魚套餐
진열 선반=n.貨架子
진열 대복 할인=n.
밥반찬=n.(下飯)菜肴
반찬단지=n.菜罐子
반찬단지.1=n.1.戲稱有求必應的人
마른반찬=n.乾菜。(沒有湯水的菜，如魚幹、紫菜等)
반찬 배달=n.
반찬 그릇=n.
권유장=n.
시야.1=n.1.眼界,目光
뒷마당=n.後院
드립=n.
못난이=n. {諷}沒出息的；不爭氣的
화음=n.和音；和聲。
가리=n.가리새”的略語。頭緒。條理
가리.1=n.1.[화학] 鉀
가리.2=n.2. 堆。垛
가리.4=n.4. (漁具)漁罩。
총가치=n.總價值
넉살=n.厚顏。臉皮厚。會來事兒。大方
산성.1=n.1.山城
산성역=n.山城站
주야장천=n.晝夜長川。晝夜不息。
도마.1=n.1. [체육학] 跳箱。
칼도마=n.案板。菜板
항균도마=n. 抗菌切菜板
나무 도마=n.
낚시 도마=n.
평론가=n.評論家
시사 평론가=n.
인성=n.人性,品性；人品
인성.1=n.1.個性
인성.2=n.2.[물리] 韌性
인성 본성=n.
조치.1=n.1.燉菜。燒菜
닷 말=n.5鬥
욕이오=n.6.25戰爭；韓國戰爭；朝鮮戰爭。
도배지=n.壁紙,塗褙紙
도배=n.裱糊,塗褙
도배.1=n.1. 滿是。指用同樣種類的物品或字填滿某個空間。
야기=n. 夜間的空氣。夜氣
야기.1=n.1.引起。導致。惹。引發。
야기죽야기죽=n.冷嘲熱諷
야기 요단=n.惹事生非。
구석자리=n.角落位置
점검표=n.[의학] 核對〈檢查〉帳目清單，核對表(英語：check list)
점검필=n.驗訖 examed
항구적=n.永久；恒久。
인화=n.引火。易燃。
인화.1=n.1.印花
인화.2=n.2.沖洗(照片)。印畫
인화.3=n.3.人和。和睦。
인화성물질=n.易燃物質。
랭킹=n.排名,ranking
오피니언=n.opinion
안팎.1=n.1. 左右；上下。用於表示數量的詞語後面
집 안팎=n.
안팎노자=n.往返路費。來回盤纏
안팎장사=n.來回做買賣
수확량=n.產量；收成
이듬해=n.第二年
도부=n.行商,到付
도부.1=n.1. 行文到達
북한.1=n.1. (生物分佈的)北限。
거짓마침=n.[음악] 假止。
거짓 근시=n.[의학] 假近視。
거짓 버림=n.[컴퓨터] 誤查 (false drop)
거짓 성대=n.假聲帶
거짓 웃음=n.
거짓 공격=n.
거짓말 탐지기=n..[기계] 测谎器。
깐깐오월=n.漫長五月。(指陰曆五月)
오월로=n.五月爐。雞肋。(無關緊要而沒了又可惜的東西)
오월.1=n.1.梧月。陰曆七月
오월.2=n.2.互為吳越。(指敵對關係)
일월.1=n.1.日月
일월광=n.日月光
이월.1=n.1.[경제] 結轉。滾存
이월.2=n.2.[경제] 轉帳
이월일=n.
유월도=n.식물] 六月桃。(早熟桃品種之一)
유월 사흗날=n.6月初三。
메뚜기도 유월이 한철이다=n.{貶}得意一時而忘乎所以。
점검매매=n.看貨買賣 sales by inspection
안전점검=n.安全檢查
점검매입=n.
표본점검=n.[경제] 抽樣檢查(檢驗)
재고=n.庫存。
재고.1=n.1.庫存；存倉
재고.2=n.2.再考慮；重新考慮。
재고표=n.存貨標籤
텍스트북=n.課本。教科書。教材。 (textbook (영))
텔레텍스트=n. 電視文字廣播。電視雜誌。teletext
텍스트 모드=n.[컴퓨터] 文本方式 (text mode)
그물 형태=n.
마감 볼=n.尾珠
출원마감=n.申請期限 deadling for application
계약마감=n.(期貨，期權交易中)合同結束 close-out
계정마감=n.[경제] 結帳；結平帳戶
천지=n.天地,世界
천지.1=n.1.天下；海洋
천지.2=n.2.[지리] 天池
일순간=n.一瞬間；一刹那
시울=n.圈。邊。
십년지기=n.十年知己
십년지계=n.十年之計
절개술=n.割口，切口
절개술.1=n.1.切除，割開
고막절개술=n.[의학] 鼓膜切開術，鼓膜穿破術(英語：myringotomy)
누낭절개술=n.[의학] 淚囊切開術(英語：dacryocystotomy)
동맥절개술=n.[의학] 動脈切開術(英語：arteriotomy)
제왕절개술=n.[의학] 剖腹產術(英語：Cesarean section)
척수절개술=n.[의학] 脊髓切開術(英語：myelotomy)
판맥절개술=n.[의학] 瓣膜切開術(英語：valvulotomy)
흉골절개술=n.[의학] 胸骨切開術(英語：sternotomy)
괄약근절개술=n.[의학] 括約肌切開術(英語：sphincterotomy)
동맥류절개술=n.[의학] 動脈瘤切開術(英語：aneurysmotomy)
장담낭절개술=n.[의학] 小腸膽囊吻合術(英語：enterocholecystostomy)
치골절개술=n.恥骨切開術
유문근층절개술=n.[의학] 幽門肌切開術(英語：pyloromyotomy)
총담관절개술=n.膽總管切開術
질식제왕절개술=n.經陰道剖腹產術。
전립선샘방광절개술=n.[의학] 前列腺膀胱切開術(英語：prostatocystotomy)
성문법=n.[법률] 成文法
성문위의=n.[의학] 聲門上的(英語：supraglottic)
성문하의=n.[의학] 聲門下的(英語：subglottic)
성문 계약=n.[법률] 書面合同
성문 헌법=n.
인세=n.印稅。版稅。
폐.1=n.1.麻煩。
폐.2=n.2.弊端
폐.3=n.3.肺
땀 냄새=n.汗味
교훈.1=n.1.教訓
아침잠=n. 晨覺
십상=n.十有八九；十之八九
십상.1=n.1. 正好。正合適
평균 기온=n.[기상] 平均气温。
생대 기온=n.
기온 역전층=n.氣溫逆增層。氣溫逆轉層
연평균 기온=n.
기온역전 현상=n.
낮 기온=n.白天氣溫
늦바람=n.老來風流。老不正經
늦바람.1=n.1.晚風
겹겹=n.層層, 很多層
신세타령=n.嘮叨命苦。怨天怨命
철창신세=n.監禁的命運
찬밥신세=n.受冷落
따라지신세=n. 窮命。苦命。
개구리밥 신세=n.命如漂流的浮萍
집터=n.宅基地
집터.1=n.1.房址
집터서리=n.房子外側。
진작.1=n.1.振作；振奮
진작.2=n.2. [음악] 真勺調。(高麗時期俗歌中最快的曲調)
고소=n.苦笑
고소.1=n.1.高處
고소.2=n.2.老巢。老窩
고소.3=n.3. 起訴；狀告
고소 취하=n.撤回起訴
고소작업대=n. 高空作業平臺。升降工作車
고소 공포증=n.懼高症
고소 작업차=n. 高空作業車。高架作業車
고소 작업 장비=n.高空作業裝備。
유압 고소작업대=n.液壓式高空作業台
자주식 고소작업대=n.自走式高空作業台
자주식 고소작업차=n.自走式高空作業車。
굴절형 고소 작업차=n.曲臂式升降機
신축식 고소 작업차=n.伸縮式高空作業車
물결털=n.[생물] 纖毛。纖維。
물결무늬=n.波狀紋。波紋。
황금물결=n.金波。金浪
물결구름=n.[기상] 波状云
물결나비=n.[동물] (Ypthima motschulskyi) 東亞鏈紋眼蝶
개화 물결=n.開化浪潮
물결 나시=n.波浪背心
물결 날염=n.波紋印染
물결 라인=n.波紋線條
물결 반지=n.波浪戒指
물결 배색=n.波紋配色
물결 소매=n.波紋袖子
물결 자수=n.波紋刺繡
물결 접시=n.波紋碟子
공포.1=n.1.公佈；頒佈。
공포.2=n.2.[역사] 貢布。(朝鮮時期，外居官奴婢頂身役交的布)
공포.3=n.3.[건축] 栱包
공포.4=n.4.空槍
공포.5=n.5.功布。(葬禮時擦拭棺材的布)
공포시장=n.接近恐慌的市場 near-panic market
법률공포=n.[경제] 頒佈法律
공포 정치=n.[정치] 恐怖政治
철도공포=n.火車恐懼症。
질병공포=n.疾病恐怖症。
공포의 보수=n.[영화] 恐懼的報酬(Le Salaire de la peur, 1953)
추모형공포=n.畸形恐怖。
공포 관리 이론=n.(心理學)恐懼管理理論。
버퍼링제=n.緩衝劑。 (buffering (영))
저마다.1=n.1.各自
천연두=n.天花
근성.1=n.1.庸俗習氣。世俗劣根性。
속물근성=n. 庸俗習氣。世俗劣根性。
인지.1=n.1.印紙,印花
감격=n.激動；感慨。
거친=n.[의학] 粗糙的(英語：coarse)
지은=n.知恩。感恩
지은.1=n.1. 至恩。大恩
골계극=n.滑稽劇
외지=n.偏僻
외지.1=n.1.國外；外國
외지.2=n.2.外國雜誌。
외지.3=n.3.[불교] 外智。(佛教三智之一，即觀察外界的智慧)
외지.4=n.4.外國報紙。
외지.5=n.5.醃黃瓜。“오이지”的略語
외지수입=n.外資輸入 import of foreign capital, introduction of foreign capital
추모=n.追悼；緬懷。
추모.1=n.1.醜貌。醜容
외지무역=n.國外當地貿易 trade on the spot
사치=n. 奢侈；闊綽
사치 관세=n.[경제] 奢侈品關稅。
사치 풍조=n.奢侈風氣。
사치금지법=n.奢侈取締法 sumptuary law
위급상태=n.
지우=n.智與愚
지우.1=n.1.知遇
지우.2=n.2.知友。知心朋友。知己
다시 멸치=n.
멸치 액젓=n.小銀魚汁
멸치 어장=n.鯷魚漁區
염장 멸치=n.鹽醃黑背鰛
지리 멸치=n.小鯷魚
통영 멸치=n.統營小魚。
열등 인종=n.劣等人種
열등의식=n.劣等意識。自卑意識。
총이익금=n.收益 gross profit
예상이익금=n.預期利益 expected profit
종이컵 받침=n.紙杯墊。紙杯托。
부조.3=n.3.[식물] (菱角等)浮藻
부조.4=n.4.禮金
부조전래=n. 祖傳
경제부조=n.經濟不調 economic disharmony
공공부조=n.公共救濟 public helping
교육부조=n.教育補貼 maintenance allowance
군상부조=n.群像浮雕
부조정실=n. (電視臺)副控制室
사회부조=n.社會扶助 social assistance
유족부조=n.遺屬撫恤 survivor's benefit
재해부조=n.災害救濟 disaster relief
공적부조=n.[사회학] 政府救濟
국가부조=n.[사회학] 國家扶助
법률 부조=n.求助法律。
상호 부조=n.[사회학] 互助。
공적부조사업=n.政府援助事業 public assistance
자율신경 부조=n.自律神經失調
실버 침=n.銀針。
킬 힐=n.高跟鞋
청키힐=n.粗跟。
가죽 힐=n.皮高跟鞋
기본 힐=n.基本高跟。
레더 힐=n.皮跟。
리본 힐=n.蝴蝶結高跟。
바닥 첫째=n.倒數第一
첫째 과업=n.第一課題。
데뷔전=n.(選手或教練)首次參賽。處女秀
데뷔 작=n.登壇作品。出道作品。
데뷔 연도=n.出道年度。
졸업증서=n.畢業證書
졸업 사정=n.畢業評定
졸업 시험=n.畢業考試
졸업 정원제=n.[교육] (大學)定額畢業制度
헤어 매니큐어=n.打蠟染發膏
브러시=n. 刷子；毛刷
부화=n. 附和
부화.1=n.1.孵化
만들기=n.製作
진땀=n. 大汗
진땀.1=n.1.冷汗
진땀.2=n.2.虛汗
그자=n. {貶}那個傢伙。
섣달 대목=n.年關
대목=n.段
대목.1=n.1.旺季
단락=n.段落
쿠바=n.古巴
헤어드라이기=n.吹風機
네일 드라이기=n.美甲吹風機
선반.1=n.1.擱板
선반들=n.架子。擱板。隔板
데코=n.裝飾
오라=n. [역사] (捆綁盜賊或犯人用的)捕繩。警繩
차돌된장=n.[음식명] 牛胸肉大醬湯
차돌모래=n.[광물] 石英砂。矽砂
차돌쌈밥=n.[음식명] 牛胸肉生菜包飯
버섯차돌구이=n.[음식명] 蘑菇烤牛胸肉
큰버섯차돌구이=n.[음식명] 大蘑菇烤牛胸肉
시키트 사격=n.[체육학] 雙向飛碟射擊。
스케이트.1=n.1.滑冰
롤러스케이트=n.溜冰鞋；旱冰鞋
스케이트보드=n.滑輪
렘니스케이트=n.雙紐線(lemniscate)
피겨스케이트=n.花樣滑冰
쇼트스케이트=n.速滑刀。速滑鞋
스케이트 커버=n.冰刀套
프로 스케이트=n.職業滑冰
하키 스케이트=n.冰球鞋。冰球刀鞋
아이스스케이트=n.冰刀；溜冰鞋(ice skate)
인라인스케이트=n. 滑輪
발광 스케이트=n.發光溜冰鞋
졸업장=n. 畢業證
근심걱정=n.憂慮
뒤끝=n.末尾。最後。末了。
실천력=n.實踐能力
정률=n. (自然科學)定律。定理。
사기 진작=n.振作士氣
모음=n.母音；母音
모음근=n.[생물] 收肌，內收肌(英語：adductor)
극단.1=n.1.極端；極點
극단.2=n.2.[예술] 劇壇。戲劇界。
극단정책=n.邊緣政策 brinkmanship
아이보리 경우=n.象牙白的情況
심지=n.(燈、蠟燭等的)芯；撚
심지.1=n.1.意志；心志
심지.2=n.2.心地
심지.3=n.3.芯；導火線
심지.4=n.4.棉花；碎布
폭죽=n.鞭炮；爆竹；煙花
불꽃놀이=n.煙花
추위.1=n.1. [동물] 皺胃
추위.2=n.2.推諉。推脫
개방.1=n.1. (為使囚犯幹活)放風
개방.2=n.2. [수학] 開方。
험담=n.誹謗；詆毀。
부보위험담보조건=n.投保風險擔保條款 additional clause
심상=n.[심리학] 影像。表像
정당.1=n.1.正堂。正廳
정당.2=n.2.大廳
발발.3=n.3.爆發
질것=n.瓦器
찰것=n.黏食品
딴것=n.別的
까짓것=n.那。那點。
어린것=n.{昵}小傢伙；小不點兒
미친것=n. (俗稱)瘋子。狂人。
지친것=n. (鄙稱)退下來的。退休的
개근상장=n.滿勤獎狀。全勤獎狀
우등상장=n.優等獎狀
변경상장=n.(股票)變更上市 change listing
상장등록=n.上市登記 listing register
상장증권=n.上市證券 listed bond
일반상장=n.一般上市 general listing.普通上市
명령상장=n.指令上市 listing by order
밑줄=n. 底線；下線。
숙식=n.食宿；吃住
숙식 제공=n.提供食宿
어울림공원=n.[관광지] 互動公園
어울림문화공원=n.[관광지] 互動文化公園
공원.1=n.1.工；工人；員工
나중.1=n.1.後；之後。
재협상=n.再協商。重新協商
방위비=n.防衛費
지렛대효과=n.杠杆效應 leverage effect
지렛대 원리=n.杠杆原理。
엿새=n.六號；六日
이레=n.七日；七號
보좌관=n. (某官職的)助理。
보좌=n.輔佐･補佐
보좌.1=n.1.寶座
발언=n.發言；講話
중대 발언=n.重大發言
자명 발언=n.指名發言
가존=n.家尊。(敬辭，對人稱自己的父親)
국방부=n.國防部
국방=n.國防；保衛國家
다이어리=n.日記。日誌。日記簿。
다이어리 스티커=n.記事本貼紙
프라워=n.花
여드레=n.八號；八日
아흐레=n.第九天。
열하루=n.11號
열이틀=12號
스무날=n.20號
그믐=n.晦日.月底
그믐께=n.月底
섣달그믐=n.除夕。大年三十。
정월 그믐=n.元月31日。
술꾼=n.酒鬼
벼때=n. [농업] 割稻時節
벼놓사=n.種稻子；種水稻
대추벼=n.[식물] 棗稻。(晚稻之一，色紅而無芒)
벼 이삭=n.稻穗。
벼쭉정이=n.癟稻子。
벼바구미=n.[동물] (Echinocnemus squameus)稻鱗象蟲。稻葉象蟲。稻象鼻蟲。稻象蟲。
벼잎벌레=n.[동물] (Lema oryzae)稻負泥蟲。
벼 이앙기=n.水稻插秧機
벼 정미기=n.稻穀精加工機。
벼 탈각기=n.稻穀去殼機。稻穀脫殼機。
벼 탈곡기=n.水稻脫粒機
일모작 벼=n.單季稻
벼 직파 재배  농업=n.水稻直播栽培技術
홀로 파이어=n.中空纖維
핏자국=n.血跡。
서술=n.敘述
서술어=n.敍述語.謂語
어간=n.詞幹
어간.1=n.1.魚肝
의미.1=n.1.目的；意圖。
문법적 의미=n.語法意義。
비틀걸음=n. 步履蹣跚。搖晃著走
연결 미어=n.連接詞尾
대등적 연결 미어=n.[언어학] 對等連接詞尾。
대치=n.對置。對著放
대치.1=n.1.對峙。對壘。對陣
대치.2=n.2.代置。替換。代替。取代
시상=n.頒獎
전생애 발달 관점=n.(心理學)生命期發展觀
팩.5=n.5.面膜
팩.6=n.6. (塑膠或紙做的)盒；包；袋。
핫팩=n.暖手寶。
코 팩=n.鼻貼。
디카팩=n.數碼相機膜。
라듐팩=n. [의학] 鐳療器。鐳源
머드팩=n.泥漿面膜。
비닐팩=n.塑膠膜
스킨팩=n.護膚面膜
식스팩=n.六塊腹肌
우유팩=n.牛奶盒
진공팩=n.真空袋
찜질팩=n.熱敷貼
헤어팩=n.發膜
고무 팩=n.橡皮膜
다시 팩=n.鍋底湯料包
멀티 팩=n.
탁족=n.洗腳,泡腳,濯足
토라=n.土螺
배뇨=n.排尿
지연성배뇨=n.延遲排尿
등록금=n.學費
등록=n.註冊；登記；報名。
등록.1=n.1.抄寫。謄寫。
등록.2=n.2.先例記錄
참견=n. 管；干預；摻和
경기 참견=n.觀看比賽。
독장수셈=n.如意算盤。做美夢
기일.2=n.2.期；日期；期限
경매기일=n.拍賣日 time of auction
납기기일=n.交貨日期 delivery date
납세기일=n.納稅日 tax due date
추일사가지=n.推一事可知,舉一反三。觸類旁通
가지장아찌=n.醬茄子
꼬마.1=n.1.小。用於一些名詞前，作定語
꼬마.2=n.2.{諷}小不點兒
꼬마전구=n.小燈泡。(通常指手電筒的燈泡和裝飾燈)
꼬마호빵=n.娃娃蒸包
꼬마 동무=n.小朋友
꼬마 버스=n.小巴士
꼬마 전사=n.小戰士
꼬마 지프=n.小吉普
꼬마 해적=n.小海盜
꼬마물떼새=n.[동물] (Charadrius dubius)金眶鴴。黑領鴴。북 알도요
꼬마물방개=n.[동물] 小魚苗龍虱
꼬마 가그린=n.兒童漱口水
꼬마 이야기=n.kids-story
꼬마 자동차=n.小汽車
꼬마 하트 목걸이=n.小心形項鍊。
안경 쓴 꼬마 신사=n.戴眼鏡的小紳士
대문턱=n.大門檻
덜밋대문=n.[건축] 後大門
일각 대문=n.單柱大門
중턱 대문=n.齊簷大門
자바라 대문=n.伸縮式大門
접절식 대문=n.合頁式大門。
정강이=n.小腿
야유.1=n.1.野遊。郊遊
야유.2=n.2. [민속] 野外假面遊戲
질.1=n.1.[생물] 陰道。膣。
질.2=n.2.指某種活兒或動作。加在一些表示工具或身體的名詞後面。
질.3=n.3.貶} 指某種行為。加在一些名詞後面。
질.4=n.4.指弄出聲音的行為。加在一些擬聲詞後面。
가재.1=n.1.家財
가재찜=n.[음식명] 蒸鼇蝦
가재걸음=n.螃蟹步
가재도구=n.家什；家當。
가재수염=n.八字須
깐쇼가재=n.[음식명] 幹燒鼇蝦
깐풍가재=n.[음식명] 幹烹螯蝦
등진 가재=n.仗勢欺人的人。依仗他人勢力的人
가재특별보험=n.家庭財產特別(保)險 special insurance of household goods
콜=n.好的，沒問題(call)
콜.1=n.1.[경제] 短期貸款。 (call loan (영))
이용료=n.使用費 utility fee
췌장암=n.[의학] 胰腺癌
췌장의=n.[의학] 胰臟的(英語：pancreatic)
한겨례=n.同胞
누기=n.潮。潮氣。濕氣
누기.1=n.1. [생물] 淚器。
자연 도대=n.[생물] 自然淘汰。自然選擇
독장=n.獨場
호흡.2=n.2.節奏
게걸=n.饞嘴。饞。貪吃。貪。貪婪。
적기.1=n.1.赤旗。紅旗
부담.1=n.1.承擔；責任
부담.2=n.2.(肉體或精神上感受到的)負擔；壓力。
부담롱=n.馱箱。(馬馱運用的小箱子)
국고부담=n.國家負擔 state liability
위험부담=n.承保險種 bearing a risk
부담비율=n.(聯保等)分攤比率 burden rate
부담위험=n.承保風險 risk covered
비용부담=n.付費 bearing expense
세금부담=n.稅負 tax burden
지출부담=n.開支負擔 expenditure burden
흐름.1=n.1. 走向；潮流
시간.2=n.2.小時
연날리기=n.放風箏
연날리가장=n.[관광지] 放風箏專用場地
간직.1=n.1.藏。收藏。保存。保管。
간직.2=n.2.銘記。銘刻。珍惜
익스프레스=n.(美國)捷運公司 Express 
성인.1=n.1.聖人
성인.2=n.2.成因
네일=n.美甲
책상 정리=n.書桌整理
정리.1=n.1.整理
정리.2=n.2.清理；裁減
정리.3=n.3.了斷；分手
정리.4=n.4.列印(存摺)明細
정리.5=n.5.清理
정리.6=n.6.[수학] 定理
정리.7=n.7.正理
거동=n.舉動；行動
거동.1=n.1. 去冬
권리증서=n.權利證書 documents of title
신용.1=n.1.信譽
잔걸음=n.走來走去。來回穿梭
잔걸음.1=n.1.碎步
태그=n. [체육학] (棒球)觸殺。
네임편=n.簽字筆
서릿발=n.霜花
헹가래=n.(為祝賀或懲罰，把人)舉起來向上拋。
흰소리=n.大話。吹牛。
줄행랑=n.(大門兩側的)長廊。
줄행랑.1=n.1.(鄙稱)逃走。逃跑。逃串。
엉너리=n.討好。獻殷勤。
뺑소니=n.逃跑。逃逸。跑掉。溜掉
뺑소니차=n.(俗稱)(肇事後)逃逸的車
을러방망이=n.威脅。恫嚇。
간격두기=n.[의학] 間隔，間距(英語：spacing)
간갹두기.1=n.1.時間間隔，調節間隔
두기=n.[천문] 鬥星和箕星
퉁퉁증=n.上火。慪氣
핵미사일=n.[군사] 核導彈。
미사일 기지=n.導彈基地
대공 미사일=n.[군사] 對空導彈。
서브미사일=n.子導彈；導彈的一級；彈頭殺傷元件(submissile)
미사일 단투=n.導彈彈頭
미사일 함정=n.導彈艦
순항미사일=n.[군사] 巡航導彈。
요격미사일=n.[군사] 攔截導彈。
탄도미사일=n.彈道導彈。 (彈道missile (영))
미사일모니터=n.導彈監視裝置(missile monitor)
지대공미사일=n.地對空導彈
지대지미사일=n.地對地導彈
다탄두 미사일=n.[군사] 多彈頭導彈
대전차 미사일=n.反坦克導彈
미사일 잠수함=n.導彈潛艇
미사일 초계전=n.導彈艇。導彈快艇
스커드 미사일=n.飛毛腿導彈。 (scud missile (영))
정거리 미사일=n.[군사] 遠端導彈。
중거리 미사일=n.中程導彈
크루즈 미사일=n.[군사] 巡航導彈
함대공 미사일=n.艦對空導彈
가이디드 미사일=n.[군사] 制導導彈
대잠수함 미사일=n.反潛導彈
주재=n.主辦；主持。
주재.1=n.1.[역사] 奏裁。(上奏以求裁可)
주재.2=n.2.做牌位的材料
주재.3=n.3.駐
상업적 주재=n.商業外駐 commercial presence
소집=n.召集；集合。
소집.1=n.1.指召集預備役軍人。
신속.1=n.臣屬。
불식=n.禁食。不吃。
불식.1=n.1.不息
불식.2=n.2.佛教儀式。佛教方式
불식.3=n.3. 消除。清除,拂拭
불식지보=n.不食之報。祖德之報。
불식지공=n.不息之工。不舍之工。慢工
주야불식=n.晝夜不息。
부지불식중=n.不知不覺。無意之中。還不知道怎麼回事。還沒弄清楚怎麼回事。
안보=n.維護國家安全
안보.1=n.1.安全；安穩
안보조항=n.分攤條款 average clause
국가 안보=n.國家安全保障
안보 의식=n.安保意識
안보전시관=n.[관광지] 安保展覽館
안보 이사회=n.“국제 연합 안전 보장 이사회(國際聯合安全保障理事會)”的略語。安理會。
요령.2=n.2.心眼
요령.4=n.4.搖鈴
구급=n. 急救；搶救
구급.1=n.1.急救；搶救。用於一般名詞前，作定語
구급약=n.急救藥
구급법=n. 急救法
구급함=n.急救箱。急救盒。
구급상자=n.急救箱
구급 가방=n.急救包
구급 밴드=n.創口貼
구급 용품=n.急救用品
구급 처치=n.[의학] 急救治療
구급 환자=n.急救患者
구급 상비약=n.常備急救藥。
구급약 상자=n.急救藥箱
구급약 세트=n.急救藥套裝
비상용 구급약=n.備用救急藥
왕진용 구급함=n.往診用急救箱
고까짓=n.那點兒
피코=n. (編織物)花邊小圈。
빈번한 질문=n.[컴퓨터] 常見問題 (frequently asked questionsFAQ)
만족.1=n.1.野蠻部族。
제기=n. (器具、器皿等)製作。製造
제기.1=n.1.提出.提起
제기.2=n.2.毽子。
제기.3=n.3. 祭祀器皿
외발제기=n.單腳踢毽子
제기차기=n.踢毽子
두발제기=n.雙腳踢毽子
넉냥=n.四兩
넉자=n. (蓋章用)鹿皮墊子
넉괭이=n.鐝頭
넉자바기=n.四字句
넉자바기.1=n.1.四言詩
배지.1=n.1.[식물] 培養基。培養液。
필름배지=n.膠片式射線計量器，膠片劑量盒(film badge)
의원 배지=n.議員徽章。
부당거래=n.不正當交易 unfair bargain
부당경쟁=n.不正當競爭 unfair competition
부당대부=n.非法放款 illegal loan(advance)
부당대출=n.非法放款 illegal advance
부당염매=n.傾銷 dumping
부당점유=n.非法佔有 wrongful possession
부당투매=n.傾銷 dumping
부당해고=n.不正當解雇 unfair dismissal
부당가격=n.不合理價格 unreasonable price
부당과세=n.不合理稅收(稅捐) unreasonable tax
부당소득=n.[경제] 不正當收入
부당이익=n.非法利益 profiteering
부당주문=n.惡意訂單 bad order
부당지출=n.不正當開支 unjust disbursement
부당표시=n.虛報 misleading representation
부당할인=n.不當扣除 unearned discount
부당이득=n.[법률] 不正當利益。非法所得
부당이득세=n.超額利潤稅 excessive profit
부당표시광고=n.虛誇廣告 misleading advertising
부당내부거래=n.非法內部交易 illegal internal transaction
부당염매가격=n.傾銷價格 dumping price
부당행위금지=n.禁止非法行為 illegal behavior prohibition
부당 노동 행위=n.不公平勞動行為
부당과소신고금액=n.[경제] 非法漏報稅額
부당 염매 방지 관세=n.防止傾銷關稅。
신선=n.新選。新當選
신선.1=n.1.神仙
우정.1=n.1.郵政
이치.1=n.1.“이 사람”的鄙稱。
몸통.1=n.1.主體；主幹部分。
굵기=n.粗細
적당=n.(一群)盜賊。
적당.1=n.1.適當。合適。恰當
적당.2=n.2.(臨時變通)適當。差不多
시말=n. 始末。原委。
빈발=n.鬢髮
빈발.1=n.1.頻發。頻頻發生
밑바닥.1=n.1.最下層；最底層
밑바닥.2=n.2.底層；根底
외상값=n.賒帳錢。賒欠款
등락거듭=n.(價格或行情)時起時落 fluctuation,徘徊浮動
탑재=n.搭載。裝載。運載
수송도중변동에 대해 매도인 책임=n.(輸送途中變動~對~賣渡人~責任)1.裸麥條件 rye-term2.到貨品質條件
가도=n.街道。
가도.1=n.1.(連接城市的)公路
가도.2=n.2.家道。家境。
가도.3=n.3.家道。家規
가도.4=n.4.(運輸業者或倉庫經營者)先交貨，後結算。
의존=n. 依靠；依賴
대외의존=n.對外依賴 external independence
문맥 의존=n.[컴퓨터] 上下文有關 (context sensitive)
의존 명사=n.[언어학] 依存名詞。不完全名詞。
의존 효과=n.消費者對生產者的依賴性。
공동 의존=n.(心理學)共依存。
의존 형태소=n.[언어학] 輔助詞素。
상호의존관계=n.
상호 의존 전략=n.相互依存戰略
단위성 의존 명사=n.[언어학] 名量詞
제휴=n.合作；聯手
기업제휴=n.企業合作 inter-enterprise cooperation, cartel
노농제휴=n.工農合作 collaboration of peasants and laborers
자본제휴=n.資本合作 capital tie-up
제휴화사=n.聯營公司 affiliated concern
경제제휴=n.經濟合作 economic cooperation
업무제휴=n.業務合作 business tie-up
기술 제휴=n.技術合作
바겐세일=n.大減價
수풀=n.草叢,樹叢
고수풀=n.[식물] (Coriandrum sativum)芫荽。香菜。
손.1=n.1.努力；精力；能力
손.2=n.2.手；掌。指權力範圍或所有範圍之內。
손.3=n.3.股掌之中。
손.4=n.4.人手
손.5=n.5.手指
보조금=n.補助金
당나귀=n.驢；驢子
뒷골목.1=n.1.黑社會
정부간섭=n.政府干涉 state intervention
간섭 현상=n. [물리] 干擾現象
내정 간섭=n.內政干涉
간섭무늬=n.[물리] 干涉紋。
물감.1=n.1. (柿子的一種)水柿。軟柿
그림물감=n.繪畫顏料
유화물감=n.油畫顏料
천연물감=n.天然染料
형광물감=n.螢光染料
검은 물감=n.黑染料
과슈 물감=n.水粉染料
강화산성=n.[관광지] 江華山城
소음.1=n.1.消音
소음공해=n.噪音公害
소음 방지=n.防止噪音
소음 차단=n.隔斷噪音
층간소음=n.層間噪音
소음측정계=n. 噪音檢測儀
충간 소음=n.樓上嘈鬧的聲音
소음 감시기=n.雜訊監視儀
소음 분석계=n. 噪音分析儀
소음 억제기=n.噪音抑制器
양자화 소음=n.[컴퓨터] 量化噪音 (quantization noise)
소음 강도 측정기=n.噪音強度測試儀。
소음 방지 바닥재=n.防噪音地面材料
생활소음규제기준=n.生活噪音限制標準 life noise regulation standard
층간 소음 방지 매트=n.樓層隔音減震墊
낭설=n.謠傳,浪說
억수=n.傾盆大雨
억수장마=n.大雨連綿。淫雨連天。
임산물생산단지=n.[관광지] 林產品生產園區
임산물채취금지=n.禁止採摘林產品
채취권=n.[법률] 開採權
물걸레=n.濕抹布。濕搌布。
물걸레 밀대=n.濕抹布拖把
물걸레 청소기=n.濕抹布吸塵器
물결 짜임=n.波紋織法
물결 패턴=n.波紋圖案
물결 펀칭=n.波紋鏤空
물결 프릴=n.波紋荷葉邊
물결 플랫=n.波紋平底鞋
밑단 물결=n.底端波紋
물결 고데기=n.波浪捲髮器
물결 레이스=n.波紋蕾絲
물결 반바지=n.波紋短褲
물결 스커트=n.波紋半身裙
물결 원피스=n.波紋連衣裙
물결 웨이브=n.波紋
물결 테이핑=n.波紋粘貼
물결 티셔트=n.波紋T恤
물결 포인트=n.波紋亮點
물결 프린트=n.波紋印花
물결무늬 칼=n.波浪紋刀
해제경보=n.解除警報
신탁해제=n.解除信託 cancellation of trust
합류해제=n.[경제] 解除扣押
이름값=n.名副其實的言行。
희소=n.稀少。稀缺。
희소가치=n.稀少價值。
희소통화=n.稀有貨幣 scare currency
희소가격=n.缺貨價格。
희소물자=n.稀有物資 scarce materials
희소자원=n.稀有資源
희소주식=n. [경제] 稀有股
소개요금=n.傭金 brokerage
강제소갸=n.強制疏散 compulsory removal
직업소개=n.職業介紹。
토지매매소개업자=n.地產經紀商 land agent
가옥매매소개업자=n.房產經紀人 house agent
다른 친구들을 소개=n.介紹其他朋友們
무명=n.棉布；粗布
무명.1=n.1.默默無聞
무명.2=n.2.無名
무명수=n. [수학] 無名數
속아가미=n.[동물] 內鰓
아가미뼈=n.[동물] 鰓骨
아가미의=n. [동물] 鰓孔。
하양=n.白；白色
두근거림=n.[의학] 心悸(英語：palpitation)
법정=n.法庭
솜씨.1=n.1. 手段；手腕
솜씨.2=n.2.才能；技巧
탈북자=n.脫北者。逃北者。
하역=n.裝卸
학역일.1=n.1.裝卸日數 working days
강행하역=n.被迫卸貨 forced discharge
미트스파게티=n.[음식명] 肉醬義大利面
버섯스피게티=n.[음식명] 蘑菇義大利面
공룡 옷=n.恐龍衣服
공룡능선=n.恐龍山脊
쿠션=n.軟墊。墊背,cushion
쿠션.1=n.1. (檯球)橡皮邊
쿠션.2=n.2. 緩衝器
이만큼.1=n.1.這些；這個程度
회화.1=n.1.會話；對話
회화 붓=n.繪畫筆。
재사회화=n.再社會化
스프치=n.(簡短的)談話。講話。
즉석 스피치=n.即席講話
센치=n.釐米
궁차지=n.[역사] 宮差知。(王室的管理人員)
백차지=n.背後衝撞(back charge)
색차지=n.(玩樂時)召妓的人
텀 차지=n.期間手續費(對交易終止前的一段時間收取費用的方式，如信用證開證費、擔保費等) term charge
호상치다=n.護喪次知
맵쌀=n.蕎麥米
가인식성=n.[철학] 可認識性。
개똥철학=n.狗屁哲學。
내재철학=n. [철학] 內在哲學。內在論。
번쇄철학=n.煩瑣哲學
까지설날=n. (兒語)除夕。年三十
세배객=n.拜年客。拜年的人
세백꾼=n.拜年的人
세뱃돈=n.壓歲錢
서슬=n.氣勢
서슬.1=n.1.刀刃
금방.2=n.2.역사] 金榜。(發佈科舉及第者的榜)
금방.3=n.3.金店
속달=n.快遞,速達
속달.1=n.1.“속달 우편(速達郵便)”的略語
소포속달=n.郵件快遞 special handling
속달운송=n.特快專遞。“빠른우편”的舊稱
속달화물=n.快運貨物 express consignment
속달운송료=n.[경제] 快運費；快遞費
속달료지급필=n.快遞費付訖 express paid
속달뱅이=n.小規模
화근=n. 禍根
부끄러움.1=n.1.羞恥；羞愧
노여움=n.憤怒；怒氣。
집약=n.集中；概括
기술집약=n.技術集約 technique-intensive
노동집약=n.勞動集約 labor-intensive
자본집약=n.資本集約 capital-intensive
집약어업=n.集約漁業 intensive fishery
집약경제=n.[경제] 集約經營
집약농업=n.[경제] 集約農業
비어=n. 粗話
비어.1=n.1.鄙稱。貶詞
비어.2=n.2.秘語。暗號
달콤=n.甜蜜
달콤한 꽃=n.甜蜜的花朵
달콤한 하루=n.甜蜜的一天
양면 달콤 니트=n.兩面甜蜜針織衫
달콤하고 아삭한=n.既甜蜜又香脆的
부드럽고 달콤한=n.柔軟又甜蜜的
아삭아삭 달콤한=n.甜甜脆脆的
시원 달콤한 천혜향=n.清爽甜蜜的天惠香
아삭아삭 신선한=n.清脆新鮮的
시조=n.始祖
장정=n.壯丁。指服勞役或兵役的男子
미품=n.微風
공간적=n.空間上的, 空間的
별빛=n.星光
별빛광장=n.[관광지] 星光廣場
별빛 큐빅 슬립온=n.月光寶石無扣鞋
큐빅=n.鑲鑽
별 큐빅=n.星星寶石
빅 큐빅=n.大寶石
큐빅 링=n.鑲鑽戒指
큐빅 백=n.寶石包
큐빅 볼=n.鑲鑽耳釘球
큐빅 진=n.寶石牛仔
큐빅 티=n.寶石T恤
나비 큐빅=n.蝴蝶水鑽
몸서리=n.冷戰；寒噤。
일익.1=n.1.一翼
경서=n. 經書
경서.1=n.1.瑞兆。喜兆
강독=n.講讀
담뱃갑=n.煙盒
담뱃값=n.煙錢
담뱃값.1=n.1.(俗)少量的錢
담뱃불 점화기=n.點煙器
담뱃불=n.點煙的火
점화기=n.點火器
점화=n.點火；點燃
겉표지=n.封皮。封面
놀라움=n.驚訝；驚奇
분별=n. 區分
분별.1=n.1.分辨；辨別
의지.2=n.2.材的代用品
의지.3=n.3.依靠, 倚, 靠
성부=n. [음악] 聲部
성부.1=n.1.(基督教、天主教)聖父。(三位一體的第一位)
뼈.1=n.1.(故事的)主幹；核心。
뼈.2=n.2.隱含的意圖或意思
뼈.3=n.3.(建築物的)骨架
줄기.1=n.1. (山)脈；(水)流
줄기.2=n.2. (學術、思想)支；道
강줄기=n.江流；江水
댓줄기=n.山嶺；山脈
산줄기=n.山嶺；山脈
나무줄기=n.樹幹
감는줄기=n. [식물] 纏繞莖
곧은줄기=n.[식물] 直立莖
기는줄기=n. [식물] 匍匐莖
덩굴줄기=n.[식물] 蔓莖。藤。藤子
덩이줄기=n. [식물] 塊莖
땅속줄기=n. [식물] 地下莖
땅위줄기=n.[식물] 地上莖
물속줄기=n.[생물] 水中莖
붙는줄기=n. [식물] 攀緣莖
비늘줄기=n.[식물] 鱗莖
뿌리줄기=n. [식물] 根莖
여린줄기=n. [동물] 魚鰭軟骨
생강줄기=n.生薑根莖
줄기상추=n.萵筍
등나무 줄기=n.藤條
감는줄기식물=n.纏繞植物
뇌하수체줄기=n.[의학] 垂體莖
태백산 산줄기=n.太白山山脈
깔끔 핏=n.簡約范兒
깔끔 란인=n.簡約線條
깔끔 셔츠=n.簡約襯衫
깔끔 재킷=n.簡約夾克
깔끔 코트=n.簡約外套
깔끔한 핏=n.簡潔的范兒
깔끔 오버핏=n.簡約寬鬆范兒
깔끔 원피스=n.簡約連衣裙
깔끔한 셔츠=n.乾淨的襯衫
깔끔한 이불=n.乾淨的被子
깔끔한 재킷=n.簡約的夾克
깔끔한 팬츠=n.俐落的緊身褲
깔끔 블라우스=n.簡約雪紡衫
깔끔한 벽시계=n.簡潔的掛鐘
깔끔한 스타일=n.乾淨俐落
깔끔한 슬리퍼=n.乾淨的拖鞋
깔끔한 에코백=n.乾淨的環保購物袋
깔끔한 원피스=n.幹練的連衣裙
깔끔한 케이스=n.乾淨的盒子
깔끔한 티셔츠=n.簡約的T恤
깔끔 정장 바지=n.乾淨俐落正裝褲
깔끔 풀라 니트=n.乾淨俐落高領針織衫
깔끔한 스니커즈=n.乾淨俐落的高幫鞋
단정하고 깔끔한=n.既端莊又整潔的
심플하고 깔끔한=n.即簡單又乾淨的
깔끔 와이드 팬츠=n.乾淨俐落的寬腿褲
깔끔 정장룩 팬츠=n.乾淨俐落正裝風格的褲子
깔끔한 여성 큐롯=n.乾淨的女性裙褲
깔끔한 체크 셔츠=n.乾淨俐落的格子襯衫
깔끔한 하프 팬츠=n.乾淨俐落的中長款褲子
단정 깔끔 티셔츠=n.端莊簡約T恤
리본 깔끔 티셔츠=n.蝴蝶結簡潔T恤
깔끔한 나이키 신발=n.乾淨的耐克鞋
융통성=n.通融性；變通性
융통성.1=n.1.周轉性；變通；通融
땅그네=n.架子秋千
그네 줄=n.秋千繩
그네뛰기=n.蕩秋千
그네비계=n.懸臂腳手架
그네 의자=n.秋千椅
뙤약볕=n.驕陽；烈日
볕=n.驕陽；烈日
적일=n.赤日
큰길가=n.大路旁
끼는 옷=n.緊身衣
티눈 수술칼=n.雞眼刀
티눈 제거 반창고=n.雞眼墊
뒤 총장=n.後側總長
기러기=n.雁，大雁
가족 생각=n.對家族的思念
쥐코밥상=n. 簡單的飯菜
밥상머리=n.飯桌前
계정격식=n.帳戶格式 account form
수심=n.獸心
수심.1=n.1. [수학] (三角形)垂心
수심.2=n.2.水心。河心。湖心
수심.3=n.3.水深
수심.4=n.4.憂愁
수심도=n.海測原圖。
첩첩수심=n.憂心忡忡。心事重重
수심 측정=n.測水深
누설=n.洩漏
의거=n. 依據；根據
벌.1=n.1.(重複做同一事情的次數)遍。次。
벌.2=n.2.原野。田野
벌.3=n.3.件；套。用於數詞後面
깍지.3=n.3.十指交叉
착오=n.錯誤。謬誤
개나리 벽지=n.迎春花紋壁紙
개나리 그림=n.連翹畫
노조경비=n.工會經費
단위노조=n.單位工會(以行業、企業為單位級成的工會) local union
자유노조=n.自由工會 free trade union
전국 노조 대표자 회의=n.全國工會代表會議
대인 관계 치료=n.(心理學)人際心理治療
아가미구멍=n. [동물] 鰓孔
비자 발급=n.發簽證
비자.1=n.1. (謙稱)奴婢,婢女
바자.2=n.2. [약학] 榧子
비자.3=n.3.[역사] 太子
약한 맥박=n. [의학] 死脈
관례=n.慣例
관례.1=n.1.冠禮。(舊時成人儀式)
관례.2=n.2.[역사] 官隸。官奴。
국제관례=n.國際慣例 international usage
외자관례=n.未婚結髮
회계관례=n.會計慣例 accounting convention
상업관례=n.商業慣例(Commercial practices)
국제조세관례=n.國際稅收慣例
춤.1=n.1.(物體的)高。幫。沿。
볼.1=n.1.臉頰。
볼.2=n.2.(腳或鞋的)寬度
양호대치=n.兩虎對峙
대치투자=n.重置投資 replacement investment
대치주문=n.替代訂貨 replacing order
양군 대치=n.兩軍對峙。兩軍對壘
대치해안선=n.疊置海岸線
주야=n.晝夜；日夜
주야.1=n.1.晝夜；日夜。以“주야로”的形式使用。不休息，一直做某事
주야겸행=n.晝夜兼程
주야골몰=n.晝夜鑽研
주야불망=n.晝夜不忘
저변=n.低息
저변.1=n.1.基數；基礎
저변.2=n.2.基層
초장=n.醬油醋。
초장.1=n.1.醋辣醬。
초장.2=n.2.(集市的)開市
초장.3=n.3.(事情的)開端
초장.4=n.4.(科舉)初場
초장.5=n.5.草場
초장.6=n.6. [식품용어] 炒醬
초장.7=n.7.(樂曲或詩歌等的)第一章
초장.8=n.8.初章
제웅=n.[민속] (驅邪用)草人
제웅.1=n.1. (比喻)草包
제웅.2=n.2.[식물] 摘除雄蕊
시리.1=n.1.主食或菜上另外附加的面、乳酪等料
사리.2=n.2.盤。用於數詞後面
사리.3=n.3.團；把
사리.4=n.4.[불교] 舍利。舍利子。
사리.5=n.5.事理。道理。
사리.6=n.6.私利。個人利益
차이.1=n.1.不同；差異
돌부덤=n.石塚
젖무덤=n.乳房。乳峰
덧널무덤=n.木槨墓
돌방무덤=n.[고고학] 石室墳
부두=n.碼頭
이삿집센터=n.搬家公司
이삿집 박스=n.搬家用箱
우주.1=n.1. [역사] 虞主。(虞祭牌位)
허위.1=n.1.虛張聲勢。
마지기=n.畝。(耕地面積單位，指下一鬥種子的地，各地標準不一，約合二三百坪，即一大畝)
강대나무=n.枯木。枯樹
강대국가=n.強國。強大的國家
강대=n.江佬屯。(舊時指首爾周邊的沿江村落)
고갈.1=n.1.耗竭；枯竭
고갈.2=n.2.乾枯
