어두운=暗い[くらい]
박음실 놀출되지않게 속만 박기=ブラインドステッチ[ぶらいんどふてっち]
블라인드 스티치 재봉기=すくい縫いミシン[すくいぬいみしん]
안 버튼=裏穴ボタン[うらあなぼたん]
다크 그린=ダークグリーン[だーくぐりーん]
플라이 프런트=ひよく[ひよく]
인털록 재봉기=インターロックミシン[いんたーろっくみしん]
고리식 자카드 직물기=リンクス柄[りんくすがら]
피케=ピケ[ぴけ]
잔주름=えくぼ[えくぼ]
심 포켓=シームポケット[しーむぽけっと]
백색=白[しろど]
눌러박기=半伏せ縫い[はんふせぬい]
반제품=半製品[はんせいひん]
한쪽 어깨가 파진 스타일=ワンショルダー[わんしょるだー]
반염=むら染め[むらそめ]
수편성=手編み[てあみ]
겉솔기 박기=巻き縫い[まきぬい]
접은 솔=くるみ縫い[くるみぬい]
잡아주기 기구=バインダー[ばいんだー]
겉덫단=イッテコイ[いってこい]
싸개 단추=くるみボタン[くるみぼたん]
사 총중량=糸ロス込み重量[いとろすこみじゅうりょう]
랩 버튼=包みボタン[つつみぼたん]
랩 스커트=ラップスカート[らっぷすかーと]
셀 버튼=貝ボタン[かいぼたん]
베스트=ベスト[べすと]
플랫록 재봉기=偏平縫いミシン[へんぺいぬいみしん]
비례자=縮尺定規[しゅくしゃくじょうぎ]
옆솔기=あいびき[あいびき]
캐주얼웨어=カジュアルウェアー[かじゅあるうぇあー]
돌먼 슬리브=ドルマンスリーブ[どるまんすりーぶ]
이지 팬츠=イージーパンツ[いーじーぱんつ]
편성 코드=編みコード[あみこーど]
테이프사=テープヤーン[てーぷやーん]
단스티치=端ミシン[たんみしん]
눌러박기=コバステッチ[こばすてっち]
편성=編み立て[あみたて]
부속 편성=付属編み[ふぞくあみ]
워치 포켓=ウォッチポケット[うぉっちぽけっと]
표준색상=スタンダードカラー[すたんだーどからー]
패치 워크=パッチワーク[ぱっちわーく]
유리 섬유=グラスファイバー[ぐらすふぁいばー]
쉬에드 크로스=スエードクロス[すえーどくろす]
난단=耳[みみ]
보더 프린트=ボーダー柄[ぼーたーがら]
포백=布帛[ふはく]
줄자=メジャー[めじゃー]
가죽끈=ストラップ[ストラップ]
생지폭=生地幅[きじはば]
원단=布地[ぬのじ]
원단=原反[げんたん]
보수사=補修糸[ほしゅういと]
부직포=不織布[ふおりぬの]
재단=裁断[さいだん]
재단기=裁断機[さいだんき]
재단대=裁断台[さいだんたい]
깅업체크=ギンガムチェック[ぎんがむちぇっく]
컬러 포멀=カラーフォーマル[からーふぉーまる]
연단대=延反台[えんたんだい]
스키퍼 칼라=スキッパー[すきっぱー]
일러스트=イラスト[いらすと]
옷개기=折り[おり]
구김=回り折り[まわりおり]
애스컷 타이=アスコットタイ[あすこっとたい]
길이=丈（長さ）[じょう（ながさ）]
슬립 드레스=スリップドレス[すりっぷどれす]
슬립=シュミーズ[しゅみーず]
나이트 가운=ナイトローブ[ないとろーぶ]
롱 스커트=ロングスカート[ろんぐすかーと]
롱 타이트 스커트=ロン・タイ[ろん・たい]
긴 양말=ハイソックス[はいそっくす]
장섬유=長繊維[ちょうせんい]
긴소매=長袖[ながそで]
미니 스커트=ミニスカート[みにすかーと]
프랜치 슬리브=フレンチスリーブ[ふれんちすりーぶ]
마이크로 스커트=マイクロミニ[まいくろみに]
심지=芯地[しんじ]
심지용 패턴=芯地用パターン[しんじようぱたーん]
셔츠=シャツ[しゃつ]
셔츠 칼라=シャツカラー[しゃつからー]
셔츠 스리브=シャツスリーブ[しゃつすりーぶ]
캐미솔 브래지어 브래지어=キャミソール[きゃみそーる]
최종 제품=最終製品[さいしゅうせいひん]
어덜트=アダルト[あだると]
오렌지=オレンジ[おれんじ]
가먼트 길이=ガーメントレングス[がーめんとれんぐす]
가먼트　염색=製品染め[せいひんぞめ]
자=物差し[ものさし]
사이즈=サイズ[さいず]
사이즈표=サイズ表[さいずひょう]
테라코타=レンガ[れんが]
프레스 재단기=ダイカットプレス機[だいかっとぷれすき]
웰트 스티치=針抜き[はりぬき]
크루넥=クルーネック[くるーねっく]
수직선=垂直線[すいちょくせん]
퓨어 컬러=純色[じゅんいろ]
울 마크=ウールマーク[うーるまーく]
더블 코트=ダッフルコート[だっふるこーと]
로 게이지=ゴーゲージ[ごーげーじ]
에메랄드 그린=エメラルド[えめらるど]
타=ダース[だーす]
티어드 스커트=ティアースカート[てぃあーすかーと]
옷소매=外袖[そとそで]
퍼프리시 블루=はな紺[はなこん]
푸시 핀=プッシュピン[ぷっしゅぴん]
드레스 핀=ドレスピン[どれすぴん]
밖소매=外袖[そとそで]
구멍뚫기 위치=目打ち印[めうちしるし]
코드 길이=コート丈[こーとたけ]
탱트톱=タンクトップ[たんくとっぷ]
줄여 봉제하다=いせ込む[いせこむ]
편성 고무=編みゴム[あみごむ]
패턴 용지=パターン用紙[ぱたーんようし]
개더=ギャザー[ぎゃざー]
플리츠 불량=プリーツ不良[ぷりーつふりょう]
그레이시 톤=グレイッシュトーン[ぐれいっしゅとーん]
입술박기=玉縁縫い[たまふちぬい]
한장으로 된옷=一枚仕立て[いちまいしたて]
일방방향=一方方向[いっぽうほうこう]
라이트 그레이=ライトグレー[らいとぐれー]
라이트 블루=ライトプルー[らいとぷるー]
하프 밀라노=片袋編み[かたふくろあみ]
싱글 자카드=シングルジャカード[しんぐるじゃかーど]
단면 자카드 직물기=シンカー柄[しんかーがら]
싱글 저지=シングルジャージー[しんぐるじゃーじー]
싱글 브레스트=シングルブレスト[しんぐるぶれすと]
외입술 주머니=片玉ポケット[かたたまぽけっと]
모노톤=モノトーン[ものとーん]
틴트=ティント[てぃんと]
단사=単糸[たんし]
1본주름=端一本押さえ[たんいっぽんおさえ]
한줄박기=一本押さえ縫い[いっぽんおさえぬい]
싱글 커프스=シングルカフス[しんぐるかふす]
라이트 퍼플=ライトパープル[らいとぱーぷる]
스토퍼=定規[じょうぎ]
솔기 고정박기 방향=縫い代倒し方向[ぬいしろだおしほうこう]
앞으로 당긴 롤러=先引きローラー[さきびきろーらー]
백싱글 크로쉐=バック細編み[ばっくほそあみ]
레오타드=レオタード[れおたーど]
가이드=ガイド[がいど]
등급=等級[とうきゅう]
요크 슬리브=ヨークスリーブ[よーくすりーぶ]
밑깃=地衿[じえり]
바탕색=地色[じいろ]
힙 행어=ヒップハンガー[ひっぷはんがー]
로 라이즈=ローライズ[ろーらいず]
힙 스타 스커트=ヒップスタースカート[ひっぷすたーすかーと]
퍼트=パット[ばっと]
송곳=目打ち[めうち]
인디고 블루=インディゴブルー[いんでぃごぶるー]
물방울=水玉[みずたま]
점선형 박기=点線模様縫い[てんせんもようぬい]
룰렛=ルレット[るれっと]
추가색상=差し色[さしいろ]
서스펜더 팬츠=サスペンダーパンツ[さすぺんだーぱんつ]
스트랩 드레스=ストラップドレス[すとらっぷどれす]
서스펜더 스커트=サスペンダースカート[さすぺんだーすかーと]
벽보=壁掛け図表[かべかけずひょう]
가터 벨트=ガーターベルト[がーたーべると]
스냅단추=ボストン[ぶすとん]
연단=延反[えんたん]
연단 장치=延反装置[えんたんそうち]
봉합=そく縫い[そくぬい]
접어 눌러박기=押さえミシン[おさえみしん]
실 자르기=糸切り[いときり]
애니멀 프린트=マニマル柄[まにまるがら]
플랩 포켓=雨蓋ポケット[あめふたぽけっと]
주자 백크레이프=バックサテン[ばっくさてん]
쇼트 코트=ショートコート[しょーとこーと]
리본=リボン[りぼん]
속옷=ズロース[ずろーす]
쇼트 팬츠=ショートパンツ[しょーとぱんつ]
쇼트=ショーツ[しょーつ]
퀼로트 스커트=キュロットスカート[きゅろっとすかーと]
스펙 염색=スペック染め[すぺっくそめ]
양말=ソックス[そっくす]
주자=サテン[さてん]
새틴 망=サテンネット[さてんねっと]
단섬유=短繊維[たんせんい]
짧은 소매=半袖[はんそで]
도비=ドビー[どびー]
멀티 컬러=マルチカラー[まるちからー]
악어=クロコダイル[くろこだいる]
캔버즈=帆布[はんふ]
롤 칼라=ロールカラー[ろーるからー]
열에 의한 변색=熟変色[じゅくへんしょく]
반대조직=逆目[ぎゃくめ]
박아 뒤집기=どんでん返し[どんでんがえし]
방안자=方眼尺[ほうがんしゃく]
안티크 골드=アンティークゴールド[あんてぃーくごーるど]
보아=ボア[ぼあ]
방모사=紡毛糸[ぼうけいと]
방적=紡績[ぼうせき]
방수 가공=防水加工[ぼうすいかこう]
방축 가공=防縮加工[ぼうしゅくかこう]
스퀘어넥=スクェアーネック[すくぇあーねっく]
폭 넓힘=増やし目[ふやしめ]
구김방지 가공=防しわ加工[ぼうしわかこう]
스칼릿=緋赤[ひあか]
체코=チャコ[ちゃこ]
분업=分業[ぶんぎょう]
그레이딩=表付け[ひょうづけ]
어소트먼트=アソートメント[あそーとめんと]
필별 재단=反別裁断[たんべつさいだん]
핑크=ピンク[ぴんく]
감침부위 접어박기=まつり縫い[まつりぬい]
부분봉제=部分縫い[ぶぶんぬい]
봉합=リンキング[りんきんぐ]
단추 달기=ボタン付け[ぼたんぐけ]
솔기 시접 가르기=割る[わる]
봉제=縫い[ぬい]
봉제 마무리=縫い終わり[みしんおわり]
소매박기=袖縫い[すでぬい]
봉제=縫製[ほうせい]
질레=ジレ[じれ]
란제리=ランジェリー[らんじぇりー]
캐미솔=キャミソール[きゃみそーる]
슬리머=スリーマー[すりーまー]
카피품=コピー商品[コピーしょうひん]
프레타포르테=プレタポルテ[ぷれたぽるて]
하이넥=ハイネック[はいねっく]
훅크=ホック[ほっく]
코바늘=鈎針[かぎばり]
속감 겉감 고정박기=中とじ[なかとじ]
합성 피혁=合成皮革[ごうせいひかく]
합성섬유=合成繊維[ごうせいせんい]
흑색=黒[くろ]
흑자개 단추=黒蝶貝ボタン[くろちょうかいぼたん]
횡단=横道[よこみち]
가장자리조각=切り替え柄[きりかえがら]
옹브레=オンブレ[おんぶれ]
건조=乾燥[かんそう]
레드=赤[あか]
백포켓=後ポケット[うしろぽけっと]
두깨=厚み[あつみ]
마무리 가공=後加工[あと　かこう]
넥벤드높이=後衿さがり[うしろえりさがり]
목뒤 주름=突きじわ[つきじわ]
레이스=レース[れーす]
모양박기=模様縫い[もようぬい]
무늬 깍임=柄ずれ[がらずれ]
케미칼 워싱=ケミカルウォッシュ[けみかるうぉっしゅ]
오프 화이트=オフオワイト[おふおわいと]
골드=ゴールド[ごーるど]
황색=イエロー[いえろー]
혼방사=混紡糸[こんぼうし]
믹싱=ミキシング[みきしんぐ]
믹스 컬러=ミックスカラー[みっくすからー]
기계자수=ミシン刺繍[みしんししゅう]
레저용 가운=ラウンジウェアー[らうんじうぇあー]
시침질=あふり止め[あぶりどめ]
피스=ピース[ぴーす]
가위=裁ちばさみ[たちばさみ]
어깨선=肩線[かたせん]
견장=肩章[けんしょう]
각박기=角縫い[かどぬい]
회전 고정축=回し固定軸[まわしこうていじく]
교직=交織[こうしょく]
속단 감침=渡しまつり[わたしまつり]
침염=浸染[しんせん]
각반=スパッツ[すぱっつ]
오픈 칼라 셔츠=開襟シャツ[かいきんしゃつ]
집업=ジップアップ[じっぷあっぷ]
오픈 칼라=オープンカラー[おーぷんからー]
팬츠=パンツ[ぱんつ]
팬츠길이=パンツ丈[ぱんつたけ]
폭=幅（巾）[はば]
넓이=広幅[ひろはば]
플레어 팬티=フレアーパンティー[ふれあーぱんてぃー]
플레어 스커트=フレアースカート[ふれあーすかーと]
패스너=ファスナー[ふぁすなー]
패스너 사이즈=ファスナー丈[ふぁすなーたけ]
늘어짐=伸ばす[のばす]
케미컬 레이스=ケミカルレース[けみかるれーす]
청색=ブルー[ぶるー]
팬티 스타킹=パンティーストッキング[ぱんてぃーすとっきんぐ]
점프 슈트=ジャンプスーツ[じゃんぷすーつ]
오버올=つなぎ[つなぎ]
목둘레=首回り[くびまわり]
사슴가죽=バックスキン[ばっくすきん]
그린=グリーン[ぐりーん]
리넨=麻[あさ]
털=ウール[うーる]
모심지=毛芯[けしん]
스웨터=せータ[せーた]
장미색=ローズ[ローズ]
면=棉[めん]
면티=コットンシャツ[こっとしゃつ]
남성복=メンズウェア[めんずうぇあ]
마스큘린=マスキュリン[ますきゅりん]
인사이트 포켓=インサイドポケット[いんさいどぽけっと]
페티코트=ペチコート[ぺちこーと]
속옷=インナーウェア[いんなーうぇあ]
데님=デニム[でにむ]
진즈=ジーンズ[じーんず]
디프 톤=ディープトーン[でぃーぷとーん]
블라우스=ブラウス[ぶらうす]
팬티=パンティー[ぱんてぃー]
오버 블라우스=オーバーブラウス[おーばーぶらうす]
구색=色なれ[いろなれ]
잠수복=ウェットスーツ[うぇっとすーつ]
퀄로트 스커트=キュロット[きゅろっと]
스커트 라이닝=スカート裏[すかーとうら]
스커트=スカート[すかーと]
스커트길이=スカート丈[すかーとたけ]
사염색=糸染め[いとぞめ]
위 몸판=上身頃[うえみごろ]
힙상당 사이즈=中ヒップ[なかひっぷ]
몸길이=着丈（身丈）[きたけ]
모카=モカ[もか]
다크 블루=濃紺[こいこん]
장갑=手袋[てぶくろ]
수하물=手荷物[てにもつ]
핸드키리=ハンドキャリー[はんどきゃりー]
핸드자수=ハンド刺繍[はんどししゅう]
미세스=シセス[みせす]
파자마=パジャマ[ぱじゃま]
스타킹=ストッキング[すとっきんぐ]
스팬사=スパン糸[すぱんいと]
보강천 박기=ヘリ縫い[へりぬい]
봉합사=糸ループ[いとるーぷ]
단추구멍=穴かがリ[あなかがり]
투피스=ツーピース[つーぴーす]
다리의류 및 양말=靴下[くつした]
스카프=スカーフ[すかーふ]
노칼라=ノーカラー[のーからー]
샤넬 슈트=シャネルスーツ[しゃねるすーつ]
운동복=ランニングシャツ[らんにんぐしゃつ]
빈소매=ノースリーブ[のーすりーぶ]
점퍼 스커트=ジャンパースカート[じゃんぱーすかーと]
서복=背広[せびろ]
테일러 슈트=テーラードスーツ[てーらーどすーつ]
블레이저 코트=ブレザージャケット[ぶれざーじゃけっと]
헴라인=ヘムライン[へむらいん]
능직=ツイル[ついる]
사선=斜線[しゃせん]
가슴 패드=バストパッド[ばすとぱっど]
소매길이=袖丈[そでたけ]
자수=刺繍[ししゅういち]
티롤리언 테이프=チロリアンテープ[ちろりあんてーぷ]
리조트웨어=リゾートウェアー[りぞーとうぇあー]
소매=袖[そで]
교복=学ラン[がくらん]
레인 코트=レインコート[れいんこーと]
목욕 가운=バスローブ[ばすろーぶ]
라운드넥=ラウンドネック[らうんどねっく]
트레이너 슈트=トレーナー[とれーなー]
머너니티 드레스=マタニティードレス[またにてぃーどれす]
턱=タック[たっく]
접어 뒤집기=折り返し[おりかえし]
저지=ジャージー[じゃーじー]
자색=パープル[ぱーぷる]
