어두운=暗的
박음실 놀출되지않게 속만 박기=暗縫
블라인드 스티치 재봉기=暗縫縫紉機
안 버튼=暗扣眼鈕扣
다크 그린=暗綠色
플라이 프런트=鈕扣蓋
인털록 재봉기=安全縫紉機
고리식 자카드 직물기=凹凸提花紋
피케=凹凸縐
잔주름=凹皺
심 포켓=擺縫袋
백색=白色
눌러박기=半包縫
반제품=半成品
한쪽 어깨가 파진 스타일=半露肩
반염=斑染
수편성=棒針
겉솔기 박기=包邊線
접은 솔=包縫
잡아주기 기구=包縫機
겉덫단=袖開口包縫
싸개 단추=包扣
사 총중량=包括 耗紗量
랩 버튼=包鈕扣
랩 스커트=包裙
셀 버튼=貝鈕扣
베스트=背心
플랫록 재봉기=繃縫縫紉機
비례자=比例尺
옆솔기=邊縫
캐주얼웨어=便服
돌먼 슬리브=蝙蝠袖
이지 팬츠=便褲
편성 코드=編碼
테이프사=扁絲紗
단스티치=邊緣縫
눌러박기=邊緣明線
편성=編織
부속 편성=編織零件
워치 포켓=表袋
표준색상=標準色樣
패치 워크=並縫布
유리 섬유=玻璃纖維
쉬에드 크로스=薄起毛布
난단=布邊
보더 프린트=布邊花樣
포백=布帛
줄자=布尺
가죽끈=布帶
생지폭=布寬
원단=布料
원단=布匹
보수사=補修紗
부직포=不織布
재단=裁剪
재단기=裁剪機
재단대=裁剪台
깅업체크=彩色格子佈
컬러 포멀=彩色禮服
연단대=裁衣料台
스키퍼 칼라=層領
일러스트=插畫
옷개기=拆
구김=拆邊
애스컷 타이=蟬形闊領
길이=長
슬립 드레스=長襯連衣裙
슬립=長襯裙
나이트 가운=長袍睡衣
롱 스커트=長裙
롱 타이트 스커트=長貼裙
긴 양말=長襪
장섬유=長纖維
긴소매=長袖
미니 스커트=迷你裙
프랜치 슬리브=超短袖
마이크로 스커트=超迷你裙
심지=襯布
심지용 패턴=襯布紙樣
셔츠=襯衫
셔츠 칼라=襯衫領
셔츠 스리브=襯衫袖
캐미솔 브래지어 브래지어=襯衣背心
최종 제품=成品
어덜트=成人裝
오렌지=橙色
가먼트 길이=成衣長
가먼트　염색=成衣染
자=尺
사이즈=尺寸
사이즈표=尺寸表
테라코타=赤褐色
프레스 재단기=沖壓裁剪機
웰트 스티치=抽針
크루넥=船員領
수직선=垂直線
퓨어 컬러=純色
울 마크=純羊毛標示
더블 코트=粗呢大衣
로 게이지=粗針
에메랄드 그린=翠綠
타=打
티어드 스커트=搭層裙
옷소매=大片袖
퍼프리시 블루=大青藍
푸시 핀=大頭釘
드레스 핀=大頭針
밖소매=大袖片
구멍뚫기 위치=打眼記號
코드 길이=大衣身長
탱트톱=大圓領女背心
줄여 봉제하다=打折
편성 고무=打褶用橡膠帶
패턴 용지=打紙樣
개더=打縐
플리츠 불량=打皺不良
그레이시 톤=帶灰色的色調
입술박기=袋口滾邊
한장으로 된옷=單層做縫
일방방향=單行布向
라이트 그레이=淡灰色
라이트 블루=淡藍色
하프 밀라노=單面胖花編織
싱글 자카드=單面提花
단면 자카드 직물기=單面提花花紋
싱글 저지=單面針織布
싱글 브레스트=單排鈕扣
외입술 주머니=單嵌袋
모노톤=單色調
틴트=淡色
단사=單紗
1본주름=單線打邊縫
한줄박기=單線疊縫
싱글 커프스=單袖口
라이트 퍼플=淡紫色
스토퍼=檔邊
솔기 고정박기 방향=倒縫份的方向
앞으로 당긴 롤러=導輥
백싱글 크로쉐=到退針
레오타드=蹈舞連衣褲
가이드=導向
등급=等級
요크 슬리브=抵肩袖
밑깃=底領
바탕색=底色
힙 행어=低腰
로 라이즈=低腰褲
힙 스타 스커트=低腰裙
퍼트=墊肩
송곳=點孔錐子
인디고 블루=靛藍
물방울=點紋花樣
점선형 박기=點線滾輪
룰렛=點線輪盤
추가색상=點綴顏色
서스펜더 팬츠=吊帶褲
스트랩 드레스=吊帶連衣裙
서스펜더 스커트=吊帶裙
벽보=吊牆圖
가터 벨트=吊襪帶
스냅단추=吊襪夾帶
연단=疊布
연단 장치=疊佈設備
봉합=疊層縫
접어 눌러박기=疊縫
실 자르기=釘鈕扣
애니멀 프린트=動物花樣
플랩 포켓=兜蓋
주자 백크레이프=緞背縐
쇼트 코트=短大衣
리본=緞帶
속옷=短汗褲
쇼트 팬츠=短褲子
쇼트=短內褲
퀼로트 스커트=短裙褲
스펙 염색=段染
양말=短襪
주자=緞文布
새틴 망=緞紋網布
단섬유=短纖維
짧은 소매=短袖
도비=多臂花式織
멀티 컬러=多色
악어=鱷魚
캔버즈=帆布
롤 칼라=翻領
열에 의한 변색=泛色
반대조직=反織紋
박아 뒤집기=翻轉
방안자=方格尺
안티크 골드=仿古金色
보아=仿毛皮布
방모사=紡毛紗
방적=紡紗
방수 가공=防水處理
방축 가공=防縮處理
스퀘어넥=方型領
폭 넓힘=放針
구김방지 가공=防皺處理
스칼릿=緋紅
체코=粉筆
분업=分工
그레이딩=分級
어소트먼트=分類組合
필별 재단=分匹裁剪
핑크=粉色
감침부위 접어박기=縫邊
부분봉제=縫部分
봉합=縫合
단추 달기=縫扣
솔기 시접 가르기=縫開
봉제=縫紉
봉제 마무리=縫完
소매박기=縫袖子
봉제=縫製
질레=婦女馬甲式背心
란제리=婦女內衣
캐미솔=婦女貼身背心
슬리머=婦女無領衫
카피품=複製品
프레타포르테=高級婦女成衣
하이넥=高領
훅크=鉤口
코바늘=鉤針
속감 겉감 고정박기=絎縫
합성 피혁=合成皮革
합성섬유=合成纖維
흑색=黑
흑자개 단추=黑蝶貝扣
횡단=橫路
가장자리조각=橫條花紋
옹브레=虹彩
건조=烘乾
레드=紅色
백포켓=後袋
두깨=厚度
마무리 가공=後加工
넥벤드높이=後領深
목뒤 주름=後領皺
레이스=花邊
모양박기=花紋縫
무늬 깍임=花紋走樣
케미칼 워싱=化學洗
오프 화이트=米白
골드=黃金色
황색=黃色
혼방사=混紡紗
믹싱=混合
믹스 컬러=混色
기계자수=機繡
레저용 가운=家常長袍
시침질=假縫
피스=件
가위=剪刀
어깨선=肩線
견장=肩章
각박기=角縫
회전 고정축=鉸鏈
교직=交織
속단 감침=接縫
침염=浸染
각반=緊身褲襪
오픈 칼라 셔츠=開襯衫
집업=開拉鍊
오픈 칼라=開領
팬츠=褲子
팬츠길이=褲子長
폭=寬
넓이=寬幅
플레어 팬티=喇叭內褲
플레어 스커트=喇叭裙
패스너=拉鍊
패스너 사이즈=拉鍊長
늘어짐=拉伸
케미컬 레이스=爛花花邊
청색=藍色
팬티 스타킹=連褲絲襪
점프 슈트=連衣
오버올=連衣工作服
목둘레=領圍
사슴가죽=鹿皮
그린=綠色
리넨=麻
털=毛
모심지=毛襯
스웨터=毛衫
장미색=玫瑰紅
면=棉
면티=棉汗衫
남성복=男裝
마스큘린=男子式的
인사이트 포켓=內袋
페티코트=內裙
속옷=內衣
데님=牛仔布
진즈=牛仔褲
디프 톤=濃色
블라우스=女襯衫
팬티=女內褲
오버 블라우스=女式長罩衫
구색=拼色
잠수복=潛水衣
퀄로트 스커트=裙褲
스커트 라이닝=裙裡
스커트=裙子
스커트길이=裙子長
사염색=染紗
위 몸판=上身
힙상당 사이즈=上臀圍
몸길이=身長
모카=深咖啡色
다크 블루=深藍色
장갑=手套
수하물=手提行李
핸드키리=手提
핸드자수=手繡
미세스=淑女裝
파자마=睡衣
스타킹=絲襪
스팬사=絲線
보강천 박기=縫邊
봉합사=鎖連線
단추구멍=鎖鈕孔
투피스=套裝
다리의류 및 양말=襪子
스카프=圍巾
노칼라=無領
샤넬 슈트=無領套裝
운동복=無領袖汗衫
빈소매=無袖
점퍼 스커트=無袖連衣裙
서복=西服
테일러 슈트=西服套裝
블레이저 코트=西服運動上衣
헴라인=下擺線
능직=斜紋布
사선=斜線
가슴 패드=胸墊
소매길이=袖長
자수=繡花
티롤리언 테이프=繡花扁帶
리조트웨어=休閒裝
소매=袖子
교복=學生製服
레인 코트=雨衣
목욕 가운=浴衣
라운드넥=圓領
트레이너 슈트=運動衫
머너니티 드레스=孕婦服
턱=褶
접어 뒤집기=折邊
저지=針織布
자색=紫色
