어두운=暗的
박음실 놀출되지않게 속만 박기=暗缝
블라인드 스티치 재봉기=暗缝缝纫机
안 버튼=暗扣眼纽扣
다크 그린=暗绿色
플라이 프런트=钮扣盖
인털록 재봉기=安全缝纫机
고리식 자카드 직물기=凹凸提花纹
피케=凹凸绉
잔주름=凹皱
심 포켓=摆缝袋
백색=白色
눌러박기=半包缝
반제품=半成品
한쪽 어깨가 파진 스타일=半露肩
반염=斑染
수편성=棒针
겉솔기 박기=包边线
접은 솔=包缝
잡아주기 기구=包缝机
겉덫단=袖开口包缝
싸개 단추=包扣
사 총중량=包括 耗纱量
랩 버튼=包纽扣
랩 스커트=包裙
셀 버튼=贝纽扣
베스트=背心
플랫록 재봉기=绷缝缝纫机
비례자=比例尺
옆솔기=边缝
캐주얼웨어=便服
돌먼 슬리브=蝙蝠袖
이지 팬츠=便裤
편성 코드=编码
테이프사=扁丝纱
단스티치=边缘缝
눌러박기=边缘明线
편성=编织
부속 편성=编织零件
워치 포켓=表袋
표준색상=标准色样
패치 워크=并缝布
유리 섬유=玻璃纤维
쉬에드 크로스=薄起毛布
난단=布边
보더 프린트=布边花样
포백=布帛
줄자=布尺
가죽끈=布带
생지폭=布宽
원단=布料
원단=布匹
보수사=补修纱
부직포=不织布
재단=裁剪
재단기=裁剪机
재단대=裁剪台
깅업체크=彩色格子布
컬러 포멀=彩色礼服
연단대=裁衣料台
스키퍼 칼라=层领
일러스트=插画
옷개기=拆
구김=拆边
애스컷 타이=蝉形阔领
길이=长
슬립 드레스=长衬连衣裙
슬립=长衬裙
나이트 가운=长袍睡衣
롱 스커트=长裙
롱 타이트 스커트=长贴裙
긴 양말=长袜
장섬유=长纤维
긴소매=长袖
미니 스커트=迷你裙
프랜치 슬리브=超短袖
마이크로 스커트=超迷你裙
심지=衬布
심지용 패턴=衬布纸样
셔츠=衬衫
셔츠 칼라=衬衫领
셔츠 스리브=衬衫袖
캐미솔 브래지어 브래지어=衬衣背心
최종 제품=成品
어덜트=成人装
오렌지=橙色
가먼트 길이=成衣长
가먼트　염색=成衣染
자=尺
사이즈=尺寸
사이즈표=尺寸表
테라코타=赤褐色
프레스 재단기=冲压裁剪机
웰트 스티치=抽针
크루넥=船员领
수직선=垂直线
퓨어 컬러=纯色
울 마크=纯羊毛标示
더블 코트=粗呢大衣
로 게이지=粗针
에메랄드 그린=翠绿
타=打
티어드 스커트=搭层裙
옷소매=大片袖
퍼프리시 블루=大青蓝
푸시 핀=大头钉
드레스 핀=大头针
밖소매=大袖片
구멍뚫기 위치=打眼记号
코드 길이=大衣身长
탱트톱=大圆领女背心
줄여 봉제하다=打折
편성 고무=打褶用橡胶带
패턴 용지=打纸样
개더=打绉
플리츠 불량=打皱不良
그레이시 톤=带灰色的色调
입술박기=袋口滚边
한장으로 된옷=单层做缝
일방방향=单行布向
라이트 그레이=淡灰色
라이트 블루=淡蓝色
하프 밀라노=单面胖花编织
싱글 자카드=单面提花
단면 자카드 직물기=单面提花花纹
싱글 저지=单面针织布
싱글 브레스트=单排纽扣
외입술 주머니=单嵌袋
모노톤=单色调
틴트=淡色
단사=单纱
1본주름=单线打边缝
한줄박기=单线叠缝
싱글 커프스=单袖口
라이트 퍼플=淡紫色
스토퍼=档边
솔기 고정박기 방향=倒缝份的方向
앞으로 당긴 롤러=导辊
백싱글 크로쉐=到退针
레오타드=蹈舞连衣裤
가이드=导向
등급=等级
요크 슬리브=抵肩袖
밑깃=底领
바탕색=底色
힙 행어=低腰
로 라이즈=低腰裤
힙 스타 스커트=低腰裙
퍼트=垫肩
송곳=点孔锥子
인디고 블루=靛蓝
물방울=点纹花样
점선형 박기=点线滚轮
룰렛=点线轮盘
추가색상=点缀颜色
서스펜더 팬츠=吊带裤
스트랩 드레스=吊带连衣裙
서스펜더 스커트=吊带裙
벽보=吊墙图
가터 벨트=吊袜带
스냅단추=吊袜夹带
연단=叠布
연단 장치=叠布设备
봉합=叠层缝
접어 눌러박기=叠缝
실 자르기=钉纽扣
애니멀 프린트=动物花样
플랩 포켓=兜盖
주자 백크레이프=缎背绉
쇼트 코트=短大衣
리본=缎带
속옷=短汗裤
쇼트 팬츠=短裤子
쇼트=短内裤
퀼로트 스커트=短裙裤
스펙 염색=段染
양말=短袜
주자=缎文布
새틴 망=缎纹网布
단섬유=短纤维
짧은 소매=短袖
도비=多臂花式织
멀티 컬러=多色
악어=鳄鱼
캔버즈=帆布
롤 칼라=翻领
열에 의한 변색=泛色
반대조직=反织纹
박아 뒤집기=翻转
방안자=方格尺
안티크 골드=仿古金色
보아=仿毛皮布
방모사=纺毛纱
방적=纺纱
방수 가공=防水处理
방축 가공=防缩处理
스퀘어넥=方型领
폭 넓힘=放针
구김방지 가공=防皱处理
스칼릿=绯红
체코=粉笔
분업=分工
그레이딩=分级
어소트먼트=分类组合
필별 재단=分匹裁剪
핑크=粉色
감침부위 접어박기=缝边
부분봉제=缝部分
봉합=缝合
단추 달기=缝扣
솔기 시접 가르기=缝开
봉제=缝纫
봉제 마무리=缝完
소매박기=缝袖子
봉제=缝制
질레=妇女马甲式背心
란제리=妇女内衣
캐미솔=妇女贴身背心
슬리머=妇女无领衫
카피품=复制品
프레타포르테=高级妇女成衣
하이넥=高领
훅크=钩口
코바늘=钩针
속감 겉감 고정박기=绗缝
합성 피혁=合成皮革
합성섬유=合成纤维
흑색=黑
흑자개 단추=黑蝶贝扣
횡단=横路
가장자리조각=横条花纹
옹브레=虹彩
건조=烘干
레드=红色
백포켓=后袋
두깨=厚度
마무리 가공=后加工
넥벤드높이=后领深
목뒤 주름=后领皱
레이스=花边
모양박기=花纹缝
무늬 깍임=花纹走样
케미칼 워싱=化学洗
오프 화이트=米白
골드=黄金色
황색=黄色
혼방사=混纺纱
믹싱=混合
믹스 컬러=混色
기계자수=机绣
레저용 가운=家常长袍
시침질=假缝
피스=件
가위=剪刀
어깨선=肩线
견장=肩章
각박기=角缝
회전 고정축=铰链
교직=交织
속단 감침=接缝
침염=浸染
각반=紧身裤袜
오픈 칼라 셔츠=开衬衫
집업=开拉链
오픈 칼라=开领
팬츠=裤子
팬츠길이=裤子长
폭=宽
넓이=宽幅
플레어 팬티=喇叭内裤
플레어 스커트=喇叭裙
패스너=拉链
패스너 사이즈=拉链长
늘어짐=拉伸
케미컬 레이스=烂花花边
청색=蓝色
팬티 스타킹=连裤丝袜
점프 슈트=连衣
오버올=连衣工作服
목둘레=领围
사슴가죽=鹿皮
그린=绿色
리넨=麻
털=毛
모심지=毛衬
스웨터=毛衫
장미색=玫瑰红
면=棉
면티=棉汗衫
남성복=男装
마스큘린=男子式的
인사이트 포켓=内袋
페티코트=内裙
속옷=内衣
데님=牛仔布
진즈=牛仔裤
디프 톤=浓色
블라우스=女衬衫
팬티=女内裤
오버 블라우스=女式长罩衫
구색=拼色
잠수복=潜水衣
퀄로트 스커트=裙裤
스커트 라이닝=裙里
스커트=裙子
스커트길이=裙子长
사염색=染纱
위 몸판=上身
힙상당 사이즈=上臀围
몸길이=身长
모카=深咖啡色
다크 블루=深蓝色
장갑=手套
수하물=手提行李
핸드키리=手提
핸드자수=手绣
미세스=淑女装
파자마=睡衣
스타킹=丝袜
스팬사=丝线
보강천 박기=缝边
봉합사=锁连线
단추구멍=锁钮孔
투피스=套装
다리의류 및 양말=袜子
스카프=围巾
노칼라=无领
샤넬 슈트=无领套装
운동복=无领袖汗衫
빈소매=无袖
점퍼 스커트=无袖连衣裙
서복=西服
테일러 슈트=西服套装
블레이저 코트=西服运动上衣
헴라인=下摆线
능직=斜纹布
사선=斜线
가슴 패드=胸垫
소매길이=袖长
자수=绣花
티롤리언 테이프=绣花扁带
리조트웨어=休闲装
소매=袖子
교복=学生制服
레인 코트=雨衣
목욕 가운=浴衣
라운드넥=圆领
트레이너 슈트=运动衫
머너니티 드레스=孕妇服
턱=褶
접어 뒤집기=折边
저지=针织布
자색=紫色
