시=點,o'clock
한시=一點,一点,一時,one o'clock
두시=二點,二点,two o'clock
세시=三點,三点,three o'clock
네시=四點,四点,四時,four o'clock
다섯시=五點,五点,五時,five o'clock
여섯시=六點,六点,六時,six o'clock
일곱시=七點,七点,七時,seven o'clock
여덟시=八點,八点,八時,eight o'clock
아홉시=九點,九点,九時,nine o'clock
열시=十點,十点,十時,ten o'clock
열한시=十一點,十一点,十一時,eleven o'clock
열두시=十二點,十二点,十二時,twelve o'clock
분=分,minute
일분=一分,one minute
이분=二分,two minutes
삼분=三分,three minutes
사분=四分,four minutes
오분=五分,five minutes
육분=六分,six minutes
칠분=七分,seven minutes
팔분=八分,eight minutes
구분=九分,nine minutes
십분=十分,ten minutes
십일분=十一分,eleven minutes
십이분=十二分,twelve minutes
이십분=廿分,twenty minutes
삼십분=卅分,thirty minutes
사십분=四十分,forty minutes
오십분=五十分,fifty minutes
오십구분=五十九分,fifty-nine minutes
새벽=凌晨,早朝,dawn,early morning
아침=早上,朝,morning
점심=中午,正午,noon
오후=下午,午後,afternoon
저녁=晚上,夕方,evening
밤=半夜,夜中,night,midnight
