가난=poverty
가상=imaginary, virtual
가치=value
갈등=conflict
감소=decrease
감염=infection
감정=emotion
강화=reinforcement, consolidation
개발=development
개산=improvement
가꾸다=take care, decorate, cultivate
가라앉다=sink, subside
가리다=conceal, cover, hide
가리키다=point
갇히다=be stuck, be shut up(in), be imprisoned
갈다=change, replace
갈아입니다=change(one's clothes)
감상하다=appreciate
갖추다=prepare, be equipped
갚다=repay, return
개다=clear up
가늘다=thin
가능하다=possible
가렵다=itchy
간편하다=simple, convenient
갑작스럽다=sudden, unexpected
강하다=strong
갸름하다=slender, slim
거칠다=rough
검다=black
게으르다=lazy
견고한다=solid, strong
가까이=nearly
가까스로=barely, narrowly
가득=fully
가만히=still, motionless
각각=each, respectively
각자=respectively
간신히=barely, narrowly
간절히=earnestly, eagerly
간혹=sometimes, occasionally
갈수록=as days[time] go(es) by
검색=search
견해=opinion
결심=resolution, determanition
결점=drawback, shortcoming
경우=case, circumstances
경쟁=competition
고객=custumer
고충=difficulty, distress
공통=common
공해=pollution
과정=process
개다=clear up
거두다=reap, win, archive
거들다=help, assist
거부하다=refuse
건네다=hand over,  talk to
겪다=experience, suffer
견디다=endure
겹치다=overlap with
고려하다=consider
과장하다=exaggerate
견고하다=strong, solid (building)
고유하다=unique
고지식하다=inflexible, rigid
공손하다=polite
과감하다=drastic, decisive
괴롭다=painfull, distress
굉장하다=wonderfull, great
굵다=thick
궁금하다=curious
귀중하다=precious
게다가=biside, moreover
겨우=barely, narrowly, only (young person)
계속=continously
결국=finally, eventually
결코=never
골고루=evenly, equally
과연=indeed, sure enough
괜히=useless, to no purpose
그대로=as it is
그저=just, only
과정=process
관련=relations (-s with, between)
교환=exchange
구매=purchase
교모=scale
균형=balance
금액=sum ( amount of money)
기금=fund
기대=expectation
기법=technique
구르다=roll over
굶다=starve
권하다=suggest, recommend
근무하다=work, be on duty
긋다=draw
기다=crawl, creep
기억나다=remember
기여하다=contribute
기울이다=lean, tilt, listen carefully to
긴장하다=be nervous (get, be)
견고하다=strong, solid
고유하다=unique
고지식하다=inflexible, rigid
공손하다=polite
과감하다=drastic, decisive
괴롭다=painfull, distressed
굉장하다=wondeefull, great
굵다=thick
궁금하다=curious
귀중하다=precious
꽤=quite
끝내=troughhout, eventually
나날이=day by day
날로=day by day
내내=throughhout
너무나=so, tall, all too
널리=wide(ly), generally
높이=highly
누누이=repeadly
달리=differently, unusual
기부=donation
기억=memory
기회=opportunity, chance
납득=understanding
노력=effort
노약자=the old and the infirm
능력=ability
답변=answer, reply
대량=large quantity
대신=instead of
까다=peel
깔다=spread out, lay
깨닫다=realize
깨뜨리다=break
깨물다=bite
꺼지다=go out, be extinguished
꽂다=put, stick
꾸미다=decorate, dress up
꾸짖다=scold
끊다=cut off, stop
끊임없다=constant
날씬하다=slim
낡다=old, warn out
낫다=better than
낯설다=unfamiliar
너그럽다=generous
넉넉하다=enough, sufficient
놀랍다=surprising, amazing
느긋하다=relaxed, easygoing
느끼하다=greasy
당분간=for a while
대개=mostly, usually
대체로=generally, mostly
더구나=besides, moreover
더욱=more, increasingly
덜=less
도대체=at all, ever
도리어=on the contrary, instead
되도록=if (it is) possible
드디어=finally, eventually
대여=rental
대응=deal with, respond
대책=measure, countermeasure
대형=large
도난=stealing
도전=challenge
도중=part-way
마무리=finish, completion
마찬가지=the same
만족=satisfaction
끌다=pull, draw
끓다=boil
끼어들다=cut in on
끼우다=put in, insert in
나뉘다=be divided
나서다=come forward, come out
나아가다=advance, (go)move forward
나타내다=appear, indicate
남다=be left over, remain
낫다=recover, get well
다름없다=same, similar
다양하다=various
다정하다=kind, friendly
단단하다=hard, firm
단순하다=simple
단정하다=neat, tidy
달콤하다=sweet
담백하다=light, clean taste
답답하다=stuffy
당연하다=natural, reasonable
딱=exactly, just
때때로=sometimes
또한=also, too
똑같이=alike, identically
뜻밖에=unexpectedly
마음껏=as much as one likes
마음대로=as one likes(pleases)
마주=face to face, opposite
마치=like, as if
마침=just, just in time
말투=ones way of speaking(talking)
매체=media
매표소=ticket office
면접=interview
면허증=license
모국어=mother tongue(native language)
모금=collection (found raising)
모순=contradiction
모집=recruitment
목표=goal, aim
낳다=give birth to, bear
내놓다=put out, take out
내주다=give
내쫓다=force sb to leave, dismiss, expel
널다=hang
넘어가다=cross, pass, go over
넘치다=overflow
녹다=melt
놀리다=tease
놓치다=miss, lose
대단하다=great, huge
독특하다=unique
동그랗다=round
동일하다=same as, equal
둔하다=slow
둥글다=round
뒤늦다=belated, late
드물다=rare, unusual
든든하다=reassured, confident, reliable
딱딱하다=hard, stiff
마침내=finally, eventually
막=just
막연히=vaguely
몰래=secretly
몹시=very much, extremely
무려=no fewer than
무사히=safely
무조건=unconditional
물론=of course, certainly
미처=yet
무게=weight
문의=inquiry
물질=substance, material
미련=lingering feeling(desire, affection) for s.th
반납=return
반대=opposite
반복=repetition
반성=self-reflectioni
반응=response (to), reaction(to)
발급=issuance
눈감다=die, overlook
늘어나다=increase
늘어서다=line(up), stand in a row
늙다=be(get) old, age
다가서다=approach
다가오다=approach
다듬다=trim
다루다=treat
다리다=iron, press
다지다=strengthen, build up
똑똑하다=smart
뚜렷하다=clear, distinct
뚱뚱하다=fat
뛰어나다=excellent, outstanding
매콤하다=hot, spicy
머지않다=soon, not too distant
멋지다=wonderful, nice
명랑하다=cheerful
목마르다=thirsty
무덥다=stifling, weltering
및=and, as well
반드시=surely, certainly
방금=jus now, a moment ago
번번이=always, all the time
보다=more
부단히=constantly, steadily
불과=only, just
비교적=relatively, comparatively
비로소=at last
비록=even though, although
발달=development
발상=thinking
발생=occurrence
발전=development
방문=visit(to)
방식=way, method
방해=disturbance, interruption
방향=direction
배려=consideration(for)
버릇=habit
다지다=strengthen, build up
다투다=quarrel, fight
달아나다=escape
달아오르다=become hot
닳다=wear(out)
담다=put sth in(into, on)
담당하다=take charge of
당기다=pull
당하다=suffer
당황하다=be embarrassed, be flustered
닿다=reach, touch
미끄럽다=slippery
미숙하다=immature
믿음직하다=be reliable
밉다=detestable
바람직하다=desirable, advisable
바르다=upright, well-mannered
버릇없다=ill-mannered
번거롭다=cumbersome, inconvenient
부끄럽다=ashamed, embarrassed
부럽다=envious of
살짝=slightly
상당히=considerably, quite
서서히=gradually, slowly
섣불리=rashly, hastly
설령=even if
설마=no way!, maybe(negative)
스스로=for(by)oneself
슬그머니=stealthily, secretly
실은=actually, in fact
실제로=really, actually
벌=punishment
범위=scope, range
범죄=crime
법=law
변경=chance
변명=excuse(for)
변화=chance
보고=report(on)
보름=two weeks, half month
보안=security
대다=put, touch
대하다=treat
더하다=be more than
던지다=throw
덜다=reduce, lighten
데다=burn oneself, scold oneself
데려오다=bring sb, fetch
도망가다=escape
도입하다=adopt, introduce
돌다=turn, rotate
부족하다=shortage, lack
분명하다=clear, distinct
분주하다=busy
불규칙하다=irregular
불쌍하다=pitiful, pathetic
불편하다=inconvenient
붉다=red
뻔하다=clear, obvious
사소하다=trivial, insignificant
상이하다=different
실컷=to one's hearts content, as muchas one like
아무래도=rather than
아무튼=in any case
어느새=before one knows
어쨌든=anyway
어쩌다가=by change, sometimes
어쩌면=maybe, perhaps
어쩐지=somehow
어차피=anyway
억지로=against one's will
보충=supplement
보호=protection
봉사=service, volunteer work
부담=burden, strain
부작용=side effect
부조리=irrationality
분량=amount, quantity
분실=loss
불법=illegality
불안=anxiety
비결=secret of(to), key(to)
돌려주다=return, give sth back to
돌보다=look after, take care of
돌아다니다=get around, go around, wander
돌아보다=look back(at)
돌아서다=turn(around, back)
되돌리다=restore
되돌아보다=look back(on), think back
되살아나다=revive
두려워하다=be afraid of
둘러보다=take a look around, browse
뒤떨어지다=fall behind, lag behind
뒤집다=turn sth inside out, overturn
상쾌하다=fresh
새롭다=new
색다르다=different, unusual
생생하다=vivid, distinct
서늘하다=cool, chilly
서운하다=hurt, sad about
서투르다=poor at, unskilled
선선하다=cool
섭섭하다=sorry, dissapointed
성숙하다=mature
성실하다=sincere, faithfull
어젠가=sometimes(past), some day(future)
얼른=quickly
여전히=still, as ever
역시=also, too, as expected
연일=day after day
오히려=instead
온통=all, wholly, entirely
왠지=somehow
요즘=these days, nowadays
워낙=so, very, by nature
원래=originally, nature
