납세고지서=纳税通知单
가산금체납금=滞纳金
보복관세=对抗关税 报复关税
분할납부=分期付款
자산조정=资产重组
외자유치=引入外资
은행예금=银行存款
자기앞수표와 유사=银行本票
환어음=银行汇票
신용장개설보증금=信用证保证金
단기투자자산=短期投资
단기투자자산 평가충당금=短期投资跌价准备
어음과수표=应收票据
미수배당금=应收股利
미수이자=应收利息
매출채권=应收账款
기타채권=其他应收款
대손충당금=坏账准备
선급금=预付账款
정부보조금 등의 미수금=应收补贴款
매입=物资采购
내구성소모품=低值易销品
재료비차이=材料成本差异
반제품=自制半成品
상품과제품=库存商品
결산시 판매가와 매입가와의 차이=商品进销差价
위탁가공한 재료의 실제원가=委托加工物资
위탁판매상품=委托代销商品
수탁판매상품=受托代销商品
재고자산평가충당금=存货跌价准备
할부판매상품=分期收款发出商品
선급비용=待摊费用
장기지분투자=长期股权投资
투자주식=股票投资
장기채권투자=长期债权投资
투자채권=债权投资
투자자산평가충당금=长期投资减值准备
원금=本金
평가충당금=减值准备
고정자산=固定资产
감가상각누계액=累计折旧
고정자산평가충당금=固定资产减值准备
대형설비선급금=预付大型设备款
건설가계정=在建工程
건설가계정평가충당금=在建工程减值准备
단기차입금=短期借款
지급어음=应付票据
외상매입금=应付帐款
수탁상품의 매출 미지급금=代销商品款
미지급급여=应付工资
미지급복리비=应付福利费
미지급배당금=应付股利
미지급세금=应缴税金
기타미지급금=其他应交款
기타미지급부채=其他应付款
미지급비용=预提费用
장기차입금=长期借款
회사채=应付债券
액면발행=债券面值
할증발행=债券益加
할인발행=债券折价
납입자본=实收资本
투자환급액=已归还投资
자본잉여금=资本公积
비현금자산수증이익=接受损益非现金资产准备
현금수증이익=接受现金损赠
외화환산차=外币资本折算差额
이익잉여금=盈余公积
법정적립금=法定盈余公积
임의적립금=任意盈余公积
준비금=储备基金
이윤으로 투자액을 환급=利润归还投资
당기순이익=本年利润
이윤분배 및 이윤분배후의 잔액=利润分配
우선주배당금=应负优先股利
제조원가=生产成本
직접제조원가=基本生产成本
간접제조원가=补助生产成本
매출원가=主营业务成本
자금조달관련비용=财务费用
전기손익수정=以前年度损益调整
기대이익=预期利益
부가세=增值税
자산부채표=资产负债表
현금=现金
외상매출금=应收帐款
미수금=其他应收款
재고 자산=存货
완제품=产成品
원부자재=原材料
반성품=半成品
유동자산=流动资产
고정자산원가=固定资产原价
무형자산=无形资产
장기투자=长期投资
이연자산=递延资产
창업비=开办费
이연세금=递延税款
미지급금=其他应付款
기타예수금=其他应交款
예수금=应交税金
선수금=预收帐款
자본=资本
자본금=资本金
자본공적=资本公积
당년이익=本年利润
미처분이익잉여금=未分配利润
자본 합계=所有者权益
손익계산서=利润表
매출액=主营业务收入
매출총이익=主营业务利润
판매비=营业费用
관리비=管理费用
재무비=财务费用
영업이익=营业利润
영업외수입=营业外收入
영업외지출=营业外支出
이익총액=利润总额
소득세=所得税
처분전이익잉여금=可供分配的利润
차기이울이익잉여금=未分配利润
세금류=税金
세수=税收
징수=征收
과세소득=课税所得
세금보완=补缴税金
조세징수=税收征收
세금추징=追缴税金
벌금을 부과=赋课税金
자진신고=自觉申报
인지세=印花税
입금=资金到位
비밀유지의무=保密义务
신용카드=信用卡
주식투자=股票投资
채권투자=债权投资
자산투자평가충당금=长期投资减値准备
이자=利贳
세미나=报告会,讨论会
재무제표=财务报表
차변=借方
대변=贷方
총비용=总费用
급료=工资
노무비=劳务费
상기업=商业
제조기업=工业
부채=负债
총계정원장=总帐
거래=往来
뺄셈=减
증빙자료=原始凭证
괘선=分线
자산=资产
분개=分类
덧셈=加
분개장=分类帐
전표=凭证
숫자=数字
정관=章程
출입국관리부처=出入境管理局
대체수표=转帐支票
경상구좌=结算户
