납세고지서=納稅通知單
가산금체납금=滯納金
보복관세=對抗關稅 報復關稅
분할납부=分期付款
자산조정=資產重組
외자유치=引入外資
은행예금=銀行存款
자기앞수표와 유사=銀行本票
환어음=銀行匯票
신용장개설보증금=信用證保證金
단기투자자산=短期投資
단기투자자산 평가충당금=短期投資跌價準備
어음과수표=應收票據
미수배당금=應收股利
미수이자=應收利息
매출채권=應收賬款
기타채권=其他應收款
대손충당금=壞賬準備
선급금=預付帳款
정부보조금 등의 미수금=應收補貼款
매입=物資採購
내구성소모품=低值易銷品
재료비차이=材料成本差異
반제품=自製半成品
상품과제품=庫存商品
결산시 판매가와 매입가와의 차이=商品進銷差價
위탁가공한 재료의 실제원가=委託加工物資
위탁판매상품=委託代銷商品
수탁판매상품=受託代銷商品
재고자산평가충당금=存貨跌價準備
할부판매상품=分期收款發出商品
선급비용=待攤費用
장기지분투자=長期股權投資
투자주식=股票投資
장기채권투자=長期債權投資
투자채권=債權投資
투자자산평가충당금=長期投資減值準備
원금=本金
평가충당금=減值準備
고정자산=固定資產
감가상각누계액=累計折舊
고정자산평가충당금=固定資產減值準備
대형설비선급금=預付大型設備款
건설가계정=在建工程
건설가계정평가충당금=在建工程減值準備
단기차입금=短期借款
지급어음=應付票據
외상매입금=應付帳款
수탁상품의 매출 미지급금=代銷商品款
미지급급여=應付工資
미지급복리비=應付福利費
미지급배당금=應付股利
미지급세금=應繳稅金
기타미지급금=其他應交款
기타미지급부채=其他應付款
미지급비용=預提費用
장기차입금=長期借款
회사채=應付債券
액면발행=債券面值
할증발행=債券益加
할인발행=債券折價
납입자본=實收資本
투자환급액=已歸還投資
자본잉여금=資本公積
비현금자산수증이익=接受損益非現金資產準備
현금수증이익=接受現金損贈
외화환산차=外幣資本折算差額
이익잉여금=盈餘公積
법정적립금=法定盈餘公積
임의적립금=任意盈餘公積
준비금=儲備基金
이윤으로 투자액을 환급=利潤歸還投資
당기순이익=本年利潤
이윤분배 및 이윤분배후의 잔액=利潤分配
우선주배당금=應負優先股利
제조원가=生產成本
직접제조원가=基本生產成本
간접제조원가=補助生產成本
매출원가=主營業務成本
자금조달관련비용=財務費用
전기손익수정=以前年度損益調整
기대이익=預期利益
부가세=增值稅
자산부채표=資產負債表
현금=現金
외상매출금=應收帳款
미수금=其他應收款
재고 자산=存貨
완제품=產成品
원부자재=原材料
반성품=半成品
유동자산=流動資產
고정자산원가=固定資產原價
무형자산=無形資產
장기투자=長期投資
이연자산=遞延資產
창업비=開辦費
이연세금=遞延稅款
미지급금=其他應付款
기타예수금=其他應交款
예수금=應交稅金
선수금=預收帳款
자본=資本
자본금=資本金
자본공적=資本公積
당년이익=本年利潤
미처분이익잉여금=未分配利潤
자본 합계=所有者權益
손익계산서=利潤表
매출액=主營業務收入
매출총이익=主營業務利潤
판매비=營業費用
관리비=管理費用
재무비=財務費用
영업이익=營業利潤
영업외수입=營業外收入
영업외지출=營業外支出
이익총액=利潤總額
소득세=所得稅
처분전이익잉여금=可供分配的利潤
차기이울이익잉여금=未分配利潤
세금류=稅金
세수=稅收
징수=徵收
과세소득=課稅所得
세금보완=補繳稅金
조세징수=稅收徵收
세금추징=追繳稅金
벌금을 부과=賦課稅金
자진신고=自覺申報
인지세=印花稅
입금=資金到位
비밀유지의무=保密義務
신용카드=信用卡
주식투자=股票投資
채권투자=債權投資
자산투자평가충당금=長期投資減値準備
이자=利貰
세미나=報告會,討論會
재무제표=財務報表
차변=借方
대변=貸方
총비용=總費用
급료=工資
노무비=勞務費
상기업=商業
제조기업=工業
부채=負債
총계정원장=總帳
거래=往來
뺄셈=減
증빙자료=原始憑證
괘선=分線
자산=資產
분개=分類
덧셈=加
분개장=分類帳
전표=憑證
숫자=數字
정관=章程
출입국관리부처=出入境管理局
대체수표=轉帳支票
경상구좌=結算戶
