불가분의=[成] 不可分離,不可分割
동문서답=[成] 答非所問｡[記] 來自"東問西答"
전화위복=[成] 逢凶化吉｡[記] 來自"轉禍為福"
동서고금=[成] 古今中外｡[记] 来自"东西古今"
군계일학=[成] 鶴立雞群｡[記] 來自"群雞一鶴"
홍익인간=[成] 弘益人間｡[記] 嚴格來講不算成語｡"弘益人間"的意思是有利於所有人, 是韓國的民族理想｡ 最初記錄在《三國遺事》中的檀君建國神話中｡
거두절미=[成] 截頭去尾｡[記] 來自"去頭截尾"
금지옥엽=[成] 金枝玉叶
고진감래=[成] 苦盡甘來｡[記] 這是中文成語的直譯
난형난제=[成] 難兄難弟
죽마고우=[成] 青梅竹馬｡[記] 來自"竹馬故友"
청천벽력=[成] 晴天霹靂
부화뇌동=[成] 人云亦云｡[記] 來自"附和雷同"
십중팔구=[成] 十有八九｡[記] 來自"十中八九"
비일비재=[成] 數不勝數｡[記] 來自"非一非再"
임기응변=[成] 随机应变｡[记] 来自"临机应变"
애지중지=[成] 疼愛有加, 愛之重之
외유내강=[成] 外柔內剛｡[記] 來自"外柔內剛"
무사안일=[成] 無事安逸, 太平｡[記] 來自"無事安逸"
선견지맹=[成] 先見之明
이심전심=[成] 心照不宣, 心心相印｡[記] 來自"以心傳心"
수수방관=[成] 袖手旁觀
일거양득=[成] 一舉兩得｡[記] 來自"一舉兩得"
일석이조=[成] 一石二鳥,一箭雙雕｡[記] 來自"一石二鳥"
일사천리=[成] 一瀉千里｡[記] 來自"一瀉千里"
역지사지=[成] 易地思之｡[記] 表示換位思考,即換一個角度思考 
유유자적=[成] 悠閒自在｡[記] 來自"悠悠自適"
우후죽순=[成] 雨後春筍｡[記] 來自"雨後春筍"
탁상공론=[成] 紙上談兵｡[記] 來自"卓上空論"
자유자재=[成] 自由自在｡[記] 來自"自由自在"
자승자박=[成] 作繭自縛｡[記] 來自"自繩自縛"
횡설수설=[成] 胡說八道｡[記] 來自"橫說豎說"
귀에 걸면 귀걸이, 코에 걸면 코걸이=[俗] 1. 看問題的角度不同會有不同的結果 2. 根據解釋的不同可以有不同的看法 3. 沒有正確的原因, 胡亂搪塞
발 없는 말이 천리 간다=[俗] 本意是沒有腳的言語可以傳到千里之外, 形容故事傳播速度飛快 
낮말은 새가 듣고 밤말은 쥐가 듣는다=[俗] 隔牆有耳｡[記] 字面意思是"白天有鳥兒聽,晚上有老鼠聽"
눈에 불을 켜다=[俗] 比喻(1)渴望佔有或非常關注 (2)怒不可遏｡[記] 字面意思是"眼睛裡點燈",也就是怒目圓睜 
모로 가도 서울만 가면 된다.=[俗] 比喻"不管過程如何,達到目標就可以"｡[記] 字面意思是"不管橫著走還是斜著走,只要到達首爾就行"
울며 겨자 먹기=[俗] 比喻被迫做不愿意做的事情｡[记] 字面意思是"哭着吃芥菜"
혀를 차다=[俗] 比喻表示不滿或者遺憾
서당 개 삼 년이면 풍월을 읊는다=[俗] 字面意思是"生活在書堂(學校)裡的狗,如果每天聽讀書的聲音,三年後也能讀出風月",比喻"新手如果在一個領域沉浸多年,也可以積累一定的知識和經驗｡" 
세치의 혓바닥이 다섯 자 몸을 좌우한다=[俗] 比喻話語的重要性, 不能信口開河｡[記] 字面意思是"三尺舌頭左右五丈軀體"
제눈에 안경=[俗] 比喻即便微不足道的東西, 只要順眼就覺得很好
이왕이면 다홍치마=[俗] 比喻既然要選擇, 那不如選擇好一點的｡[記] 字面意思是"既然要選擇,不如選粉紅色裙子" 
뱁새가 황새를 따라가면 가랑이가 찢어진다=[俗] 比喻如果勉強做困難的事情, 反而會深受其害｡[記] 字面意思是"如果鷦鷯跟著鸛鳥,嘴巴會撕裂" 
누워서 침 뱉기=[俗] 比喻想害人,反而害自己的情况｡[记] 字面意思是"躺着吐口水"
쥐 죽은 듯=[俗] 比喻鴉雀無聲｡[同] 찬물을 끼얹은 듯｡[記] 字面意思是"像了老鼠也死了一樣" 
곶감 뽑아 먹듯=[俗] 比喻一點一點地消耗精心聚集的財產｡[記] 字面意思是"像吃拔出的柿餅"｡古代的人們會把柿餅穿在一起保存,吃的時候一個個拔出來｡ 
혀를 내두른다=[俗] 比喻因對方的言語太過荒唐, 所以拒絕對話
산 입에 거미줄 치다=[俗] 比喻因為太窮所以很久都沒吃飯｡[記] 字面意思是"活人的口上編織蜘蛛網",表示這張嘴很久沒吃東西
밑 빠진 독에 물 붓기=[俗] 比喻再努力也不能成功的事情｡[记] 字面意思是"向露底的缸灌水"
말 한 마디로 천 냥 빚을 갚는다=[俗] 比喻只要口才好就能解決看似不可能解決的問題｡[記] 字面意思是"一句話可以還清千兩債務" 
싼 것이 비지떡=[俗] 便宜沒好貨｡[記] 字面意思是"便宜的是豆渣餅"｡비지指的是豆腐渣,비지떡則是豆腐渣裡添加大米粉或麵粉做出來的烤餅,在這裡比喻非常不起眼的東西｡
겉 다르고 속 다르다=[俗] 表裡不一
귀를 의심하다=[俗] 不敢相信自己的耳朵, 比喻懷疑聽到的事實
물불 가리지 않다=[俗] 不管三七二十一｡[記] 字面意思是"不分水火"
쇠뿔도 단김에 빼라=[俗] 趁热打铁｡[记] 字面意思是"牛角要一次性拔出来"
고개가 수그러지다=[俗] 耷拉著頭, 比喻認輸或者承認錯誤
혀를 굴리다=[俗] 打嘟嚕, 比喻表示不滿
일침을 가하다=[俗] 當頭一棒｡[記] 일침指的是"一支針",침是"針"的意思,因此該俗語的字面意思就是"(突然)插了一支針" 
어깨를 으쓱하다=[俗] 得意洋洋,扯高气扬
입방아 찧다=[俗] 喋喋不休
귀에 못이 박히다=[俗] 反復聽了多次相同內容的話｡[記] 因重複的次數太多,以至於像在耳朵裡釘了釘子一般牢記
골머리를 썩인다=[俗] 費勁心血｡[記] 字面意思是"爛掉大腦"
강 건너 불 보듯=[俗] 隔岸觀火
미역국을 먹다=[俗] 考試落榜或失利｡[記] 海帶湯在古代是產婦必吃的食物,同時"生孩子"和"解散"在韓語中均是해산｡傳說日本佔領朝鮮半島後解散了朝鮮軍隊, 人們借用描述產婦的"吃海帶湯"評價朝鮮軍人失去了工作｡ 後來的人們覺得海帶是很滑的食物,吃了海帶在考試中容易刷下來,因此參加考試的人儘量避免吃海帶｡
고기는 씹어야 맛이고 말은 해야 맛이다=[俗] 好比不停地嚼肉才知道肉味一样, 比喻想说的话最好都痛快地说出来｡意思是该说的话一定要说出来才行｡ 
혀 안에 도끼 들었다=[俗] 話中帶刺｡[記] 字面意思是"舌頭中有斧子" 
입에 침이 마르다=[[俗] 苦口婆心｡[記] 字面意思"口中的唾沫都幹了" 
속을 태우다=[俗] 勞心｡[記] 字面意思是"燒心"
바가지를 긁다=[俗] 唠叨｡[记] 字面意思是"用手刮水漂",一般用于形容妻子因经济问题对丈夫唠叨的情形 
눈에 선하다=[俗] 歷歷在目
줄행랑을 놓다=[俗] 溜之大吉
눈코 뜰 새 없다=[俗] 忙得不可開交｡[記] 字面意思是"沒空睜開眼睛和鼻子" 
장님 코끼리 만지듯=[俗] 盲人摸象｡[記] 장님是對盲人較委婉的稱呼 
코앞에 닥치다=[俗] 迫在眉睫
기우에 불과하다=[俗] 杞人忧天｡[记] 기우来自"杞(人)忧(天)",该俗语的字面意思为"不过是杞忧而已" 
입이 가볍다=[俗] 輕嘴薄舌
가는 말이 고와야 오는 말이 곱다=[俗] 人心長在人心上｡[記] 比喻"你要先對別人友善,別人才會對你友善"
열길 물속은 알아도 한 길 사람 속은 모른다=[俗] 人心隔肚皮, 知人知面不知心｡[记] 字面意思是"知道10길水底,也无法知道1길的人心", "길"是古代表示长度的单位｡ 1길大约是8或者10丈,也就是2.4米或3米｡
사공이 많으면 배가 산으로 올라간다=[俗] 如果每個人都想以自己的想法操縱船隻, 那麼船不能駛向水而是可能會爬到山上. 比喻如果大家都要堅持自己的主張, 那麼將一事無成.｡[記] 字面意思是"船夫多了,船就可以上山"
가시 방석에 앉은 듯한=[俗] 如坐針氈
직성이 풀리다=[俗] 實現了願望所以心理上得到了滿足, 了卻了心願
손을 떼다=[俗] 收手,停止原來做的事情
하늘이 무너져도 솟아날 구멍은 있다=[俗] 天無絕人之路｡[記] 字面意思是"天塌下來也有鑽出去的窟窿"
귀가 번쩍 뜨이다=[俗] 聽到的事情非常吸引人｡[記] 字面意思是"耳朵猛地豎起來" 
혀를 놀린다=[俗] 同 혀를 굴리다
귀가 솔깃하다=[俗] 娓娓动听｡[记] 字面意思是"竖起耳朵" 
똥 묻은 개가 겨 묻은 개 나무란다=[俗] 五十步笑百步｡[記] 字面意思是"身上粘上大便的狗嘲笑粘上糠的狗" 
날개 돋친 듯이=[俗] 迅雷不及掩耳｡[記] 字面意思是"好比長了翅膀",比喻速度很快
꿩 먹고 알 먹기=[俗] 一举两得｡[记] 字面意思是"吃了野鸡又吃(野鸡)蛋"｡[同] 일석이조
계란으로 바위 치기=[俗] 以卵击石
굴비 먹기=[俗] 易如反掌｡[记] 굴비指的是腌制的黄鱼,因此字面意思为"吃腌黄鱼",比喻非常容易的事情｡
땅 짚고 헤엄치기=[俗] 易如反掌｡[记] 字面意思是"在地上游泳"
입이 삐죽하다=[俗] 因為生氣或者不滿而不高興, 撇嘴
눈 깜짝할 사이=[俗] 眨眼的功夫,很短的时间
앞뒤를 재다=[俗] 瞻前顧後｡[記] 字面意思是"測量前後"
갈피를 잡지 못하다=[俗] 找不著北｡[記] 갈피(n.頭緒,線索)
남의 떡이 더 커 보인다=[俗] 這山望著那山高｡[記] 字面意思是"別人的餅看起來更大" 
눈을 감아주다=[俗] 睜一隻眼閉一隻眼
벼는 익을수록 고개를 숙인다=[俗] 整瓶子不動,半瓶子搖｡比喻"越有修養的人越謙虛"｡[記] 字面意思是"稻子越熟越低頭"
콩 심은 데 콩 나고 팥 심은 데 팥 난다=[俗] 種瓜得瓜, 種豆得豆
벽에 부딪치다=[俗] 撞牆, 比喻遇到困難
닭 쫓던 개 지붕 쳐다보기=[俗] 比喻努力的事情失败或者落后于其他竞争对手而无计可施｡[记] 字面意思是"被狗追的鸡跳上房顶,狗无可奈何地仰望" 
서당 개 삼 년이면 풍월을 읊는다=[俗] 字面意思是"生活在書堂(學校)裡的狗,如果每天聽讀書的聲音,三年後也能讀出風月",比喻"新手如果在一個領域沉浸多年,也可以積累一定的知識和經驗｡"
돌다리도 두들겨 보고 건너라=[俗] 比喻做自己很熟悉的事情也要小心翼翼｡[記] 字面意思是"石橋也要先敲一下再過吧" 
입이 무겁다=[俗] 嘴嚴
도둑이 제 발 저리다=[俗] 做賊心虛｡[記] 字面意思是"小偷自己的腳酸了"
