가게=n.店鋪
가격=n.價格
가구=n.傢俱
가까워지다=薄
가까이=adv.近
가깝다=adj.近,不遠
가꾸다=精心打理
가끔=adv.偶爾,有時
가난=n.貧窮
가난하다=n.貧窮
가늘다=細
가능=n.可能
가능성=可能性
가능하다=有可能
가능해지다=有可能
가다=v.去
가득=adv.充滿地
가득하다=adj.滿,滿滿
가득히=adv.滿
가라앉다=沈下去;平靜
가령=假如,如果
가로=橫著,橫向
가로등=n.路燈
가로막다=擋住
가로수=n.林蔭樹
가루=粉末
가르다=分開
가르치다=v.教
가르침=n.教導,教誨
가리다=v.挑(食);遮住
가리키다=指,指示
가만=adv.聽任,任憑,就那樣
가만있다=希望
가만히=悄悄地
가뭄=n.旱災
가방=n.包
가볍다=adj.輕
가사=n.歌詞
가상=假想
가수=n.歌手
가스=n.煤氣
가슴=胸
가슴속=n.胸中,心,心裡
가요=n.歌謠
가운데=n.當中,中間,中
가위=n.剪刀
가을=n.秋天
가이드=導遊
가입=加入
가입자=n.加入者
가입하다=v.加入
가장=adv.最
가정=n.家庭
가정교사=n.家庭教師,家教
가져가다=v.拿去
가져다주다=v.帶給,帶來
가져오다=帶來
가족=n.家庭成員,家族
가죽=n.皮(動物的)
가지=樹枝;種類
가지다=拿著
가짜=假的
가치=n.價值
가치관=n.價值觀
가톨릭=n.天主教
가하다=v.給予
각=n.角
각각=pron.各自
각국=各國
각기=各自
각오=n.決心
각자=n.各自
각종=n.各種
간=肝
간격=間隔
간단하다=adj.簡單
간단히=adv.簡單地
간부=n.幹部
간섭=n.干涉
간식=n.零食
간신히=adv.勉強地
간장=n.醬油
간접=間接
간접적=n.間接的
간판=n.招牌
간편하다=adj.簡便
간호=n.看護,護理
간호사=n.護士
간혹=adv.偶爾
갇히다=v.被關
갈다=耕,磨
갈등=n.矛盾
갈비=n.排骨
갈비탕=n.排骨湯
갈색=n.褐色
갈아입다=v.換穿(衣服)
갈아타다=v.換乘
갈증=n.渴
감=n.柿子,感覺
감각=n.感覺
감기=n.感冒
감다=v.閉眼
감독=n.導演
감동=n.感動,激動
감동적=動人的
감사=n.感謝
감사하다=adj.感謝
감상=n.感想
감상하다=欣賞
감소=n.減少
감소되다=減少
감소하다=減少
감수성=感受性
감싸다=v.庇護,包庇
감옥=n.監獄
감자=土豆
감정=n.感情
감정적=情緒化
감추다=v.掩藏
감히=adv.竟敢,膽敢
갑=盒子
갑자기=adv.突然
갑작스럽다=adj.忽然,突然
값=n.價格
값싸다=adj.廉價,便宜
강=n.江,河
강남=n.江南
강당=講堂
강도=n.搶劫,強盜
강력하다=有力
강력히=adv.強有力地
강렬하다=強烈
강물=江
강변=n.江邊,河邊
강북=江北
강사=講師
강수량=n.降水量
강아지=n.小狗
강요하다=強迫
강원도=江原道
강의=n.講授,上課
강의하다=講課
강제=強迫
강조=n.強調
강조하다=v.強調
강하다=adj.強大
강화하다=v.加強
갖가지=n.種種,各式各樣
갖다=v.拿
갖추다=v.具備
같다=adj.一樣
같이=adv.一起
같이하다=v.一起,一致,一同
갚다=v.報,報答
개=n.狗,個(數)
개개인=n.每個人
개구리=青蛙
개국=n.開國
개나리=n.連翹
개다=疊
개미=n.螞蟻
개발되다=被開發
개발하다=開發,利用
개방=n.開放
개방되다=開放
개방하다=開放
개별=個別
개선=n.改善,改進
개선되다=改善
개선하다=v.改善
개성=n.個性
개월=個月
개인=個人
개인적=人的
객관적=客觀的
걔=那傢伙
거=n.東西
거기=pron.那裡
거꾸로=正是
거대하다=巨大的
거두다=收割;養育;收拾
거들다=幫
거듭=反覆
거리=n.街;材料;距離
거부하다=v.拒絕,抗拒
거실=客廳
거액=n.額
거울=n.鏡子
거의=adv.幾乎
거절하다=拒絕
거짓=虛假
거짓말=n.謊言
거치다=經過
거칠다=adj.粗糙,(性格或態度)粗魯
거품=n.泡沫
걱정=n.擔心,操心,憂慮
걱정되다=擔心
걱정스럽다=adj.擔心,擔憂,憂慮
걱정하다=v.操心
건=件
건강=n.健康
건강하다=健康
건너=n.對面
건너가다=v.渡過
건너다=v.過(河),過(橋)
건너오다=渡過來
건너편=n.對面
건넌방=n.對面房間
건네다=v.交,遞交
건네주다=v.遞過去
건드리다=碰
건물=n.建築物
건설=n.建設
건설되다=建設,建立
건설하다=建設
건전하다=adj.健全
건조=n.乾燥,枯燥
건조하다=adj.乾燥的
건지다=撈,救
건축=建築
걷기=起腳,好走
걷다=走路;收拾
걸다=v.掛上,打電話
걸리다=v.花費(時間)
걸어가다=走
걸어오다=走來
걸음=腳步
걸치다=v.連接,架
검다=黑色的
검사=檢查
검은색=黑色
검정색=黑色
검토=核對
겁=害怕
겁나다=v.膽怯,畏懼,害怕
것=n.的,所謂
겉=表面
게=n.螃蟹
게다가=adv.加上,而且
게시판=n.公告板
게으르다=adj.懶惰
게임=遊戲
겨우=adv.好不容易
겨울=n.冬天
겨울철=冬季
겨자=n.芥菜
겪다=經歷
견디다=v.忍耐
견해=見解
결과=n.結果
결국=adv.終究,最終
결론=n.結論
결석=n.缺席
결석하다=缺席
결승=n.決賽
결심=n.決心
결심하다=決心
결정=n.決定
결정되다=被決定
결정하다=決定
결코=adv.終究
결혼=n.結婚
결혼식=n.婚禮
결혼하다=結婚
경계=境界
경고=n.警告
경고하다=警告
경기=景氣;比賽
경기도=n.京畿道
경기장=比賽場
경력=n.經歷,閱歷
경복궁=景福宮(韓國)
경비=n.經費
경영=n.經營
경영하다=經營
경우=n.情況
경쟁=n.競爭
경쟁력=n.競爭力
경제=n.經濟
경제력=n.經濟力量
경제적=經濟的
경제학=經濟學
경주=n.慶州,韓國城市
경찰=n.員警
경찰관=警官
경찰서=n.員警署
경치=風景
경향=n.傾向
경험=n.經驗
경험하다=v.經歷
곁=身旁
계곡=溪谷
계단=n.樓梯
계란=n.雞蛋
계산=n.計算
계산기=計算器
계산하다=計算
계속=adv.繼續,一直
계속되다=繼續
계속하다=繼續
계시다=adj.在(敬語)
계약=n.契約,合同
계절=n.季節
계좌=n.帳戶
계층=n.階層
계획=n.計畫
계획하다=v.計劃
고개=n.額頭
고객=n.顧客
고교=n.高等中學,高中
고구려=n.高句麗,韓國古代三國之一
고구마=地瓜
고궁=n.故宮
고급=n.高級
고급스럽다=高級的
고기=n.肉
고등학교=n.高中
고등학생=n.高中學生
고려=n.考慮
고려하다=考慮
고르다=v.挑選
고맙다=adj.謝謝
고모=姑媽
고모부=n.姑夫
고무신=n.橡皮鞋,膠鞋
고민=n.苦惱
고민하다=苦悶
고생=n.辛苦,辛勞,勞苦
고생하다=v.吃苦
고소하다=adj.香,香噴噴
고속=n.高速
고속도로=高速公路
고속버스=n.高速公交車
고양이=n.貓
고요하다=寂靜
고작=adv.充其量,頂多
고장=n.故障
고전=n.古典
고집=n.倔脾氣
고집하다=固執
고추=辣椒
고추장=n.辣椒醬
고춧가루=n.辣椒粉
고치다=v.改正
고통=n.痛苦
고통스럽다=痛苦的
고프다=adj.餓
고함=n.高喊,大喊
고향=n.故鄉
곡=n.曲子
곡식=糧食
곤란하다=困難
곧=adv.立刻
곧다=adj.直
곧바로=一直走
곧이어=adv.信(聽)
곧잘=善於
곧장=一直
골=腦
골고루=adv.均勻地
골목=巷子
골목길=n.胡同路
골짜기=n.山谷,峽谷
골치=n.腦袋,腦瓜子
골프=高爾夫球
골프장=高爾夫球場
곰=熊
곱다=好看
곳=n.地方,地點
곳곳=到處
공=球
공간=空間
공개=公開
공개하다=公開
공격=n.攻擊
공격하다=攻擊
공공=n.公共
공군=n.空軍
공급=n.供給,供應
공기=n.空氣
공동=共同
공무원=n.公務員
공부=n.學習,念書,用功
공부하다=學習
공사=n.(韓國的)國有企業,施工
공식=n.正式,公式
공식적=正式
공업=n.工業
공연=n.演出
공연되다=公演
공연장=演出現場
공연하다=公演
공연히=白白地
공원=n.公園
공장=工廠
공주=公主
공중=n.公眾,公共
공중전화=公用電話
공짜=免費的
공책=n.記事本,筆記本
공통=n.共通,共同
공통되다=共通
공통적=共同
공통점=n.共同點
공포=n.恐怖
공항=n.機場
공항버스=機場巴士
공해=n.公害
공휴일=n.公休日
과=n.科,專業
과거=n.過去
과목=科目
과연=adv.果然
과외=課外
과일=n.水果
과자=n.餅乾,點心
과장=科長
과정=課程
과제=n.課題
과학=n.科學
과학자=科學家
과학적=科學的
관객=n.觀眾
관계=關係
관계되다=關聯
관계없이=不管,無論
관계자=有關人員
관광=n.觀光
관광객=遊客
관광버스=遊覽車
관광지=觀光景點
관념=觀念
관람=n.觀覽,觀看,參觀
관련=n.關聯,相關,聯繫
관련되다=相關
관련하다=參與
관리=n.官吏
관리하다=管理
관습=n.習慣
관심=n.關心
관심사=n.關心的事情
관점=n.觀點
관찰=n.觀察
관찰하다=觀察
관하다=v.關於,有關
광경=n.光景
광고=n.廣告
광장=廣場
광주=n.光州,韓國城市
괜찮다=adj.不錯,沒關係
괜히=白白地
괴로움=n.痛苦(名詞型)
괴로워하다=難過
괴롭다=adj.(身體或情感上)難受,不舒服
괴롭히다=v.使痛苦
굉장하다=宏偉
굉장히=adv.厲害地,特別地
교과서=教科書
교내=n.校內
교대=n.交代
교류=交流
교문=校門
교복=n.校服
교사=n.教師
교수=教授
교실=n.教室
교양=n.教養
교외=教會
교육=n.教育
교육비=n.教育費
교육자=n.教育者
교장=n.校長
교재=n.教材
교직=n.教職
교체=n.交替
교통=n.交通
교통사고=n.交通事故
교포=n.僑胞
교환=n.交換
교환하다=交換
교회=n.教會
교훈=n.校訓
구=num.九
구15=15區
구경=n.觀看
구경하다=v.看
구두=n.皮鞋
구르다=v.滾
구름=雲
구멍=洞
구별=n.區別,分辨
구별되다=區分
구별하다=v.區別
구분=n.區分
구분되다=區分
구분하다=區分
구석=n.隅,角落
구석구석=adv.每個角落,到處
구성=n.構成
구성되다=構成
구성하다=構成
구속=n.約束,拘束
구속되다=被拘留
구속하다=約束
구십=90
구역=n.區域
구월=n.九月
구입=n.購入
구입하다=買進
구조=構造
구청=地方政府
구체적=具體的
구하다=v.拯救
국=湯
국가=國家
국가적=國家的
국기=國旗
국내=n.國內
국내선=n.國內航線,國內運輸線
국내외=n.國內外
국립=國立
국물=n.湯
국민=n.國民
국민적=國民的
국사=n.國史
국산=n.國產
국수=麵條
국어=n.國語
국왕=n.國王
국적=國籍
국제=國際
국제선=國際線
국제적=國際的
국제화=國際化
국회=n.國會
국회의원=n.國會議員
군=n.郡,是一個行政單位
군대=n.軍隊
군데=地方
군사=n.軍事
군인=軍人
굳다=adj.硬,堅固
굳어지다=v.變硬,硬
굳이=特意,堅決
굳히다=堅定,堅固
굵다=粗
굶다=v.餓肚子
굽다=v.烤
굽히다=v.弄彎
궁극적=終極,最終
궁금하다=adj.好奇,想知道
권=n.(書的量詞)冊
권리=權利
권위=n.權威
권투=拳擊
권하다=勸
귀=n.耳朵
귀가=回家
귀가하다=回家
귀국=n.回國
귀국하다=回國
귀신=n.(迷信)鬼,鬼魂
귀엽다=可愛
귀중하다=貴重的
귀찮다=adj.討厭,厭煩,麻煩
귀하다=adj.稀罕
귓속=n.耳朵裡
규모=n.規模
규정=n.規定,規則
규칙=n.規則
규칙적=規則的
균형=n.均衡
그=pron.那個
그간=n.那段時間
그거=pron.它
그것=pron.那個
그곳=那裡
그나마=adv.連那個
그날=那天
그냥=adv.仍舊
그녀=pron.她,那女子
그놈=他(卑稱),那傢伙
그늘=n.陰處,陰影
그다음=其次,其後
그다지=adv.不太,不怎麼
그대=您
그대로=adv.原原本本地
그동안=n.在那期間
그때=那時
그래=是的
그래도=int.對,是啊
그래서=conj.因此,所以
그래야=int.對,是啊
그래픽=圖形
그램=公克
그러나=conj.可是
그러니까=conj.所以
그러다=v.這樣做
그러면=conj.那麼,既然…就
그러므로=因此,所以
그러하다=adj.那樣
그런=n.那樣的
그런대로=adv.還,還算,好歹
그런데=conj.但是
그럴듯하다=回事
그럼=conj.那麼
그렇게=adv.那麼地
그렇다=是的,是那樣
그렇지=這樣
그렇지만=conj.但是
그려지다=畫著
그루=n.株,棵,樁子(樹砍後的)
그룹=n.集團,組織
그릇=n.盤子
그리=不怎麼
그리고=conj.還,然後
그리다=v.畫畫
그리로=adv.不怎樣
그리움=n.懷念(名詞型)
그리워하다=v.想,念
그리하여=因此
그림=n.圖畫
그림자=n.影子
그립다=想念
그만=到此
그만두다=v.停止
그만큼=adv.那種程度,那麼點
그만하다=adj.那些,那麼多
그분=那位
그사이=n.其間
그이=pron.他,她,它
그저=adv.仍然
그저께=n.前天
그전=以前
그제서야=則,然後
그제야=n.那時候
그중=尤其,特別
그쪽=對方
그치다=v.停止
그토록=adv.那樣地(表示程度)
그해=年內
극=n.極點
극복=n.克服
극복하다=v.克服
극작가=n.劇作家
극장=n.劇場
극히=adv.極,非常
근거=n.根據,證據
근거하다=根據,依據,憑據
근데=可是,不過,但是
근래=近來
근로=n.勤勞
근로자=n.勞動者
근무=n.工作
근무하다=v.工作
근본=n.根本
근본적=根本的
근원=根源
근육=肌肉
근처=n.附近
글=n.文字
글쎄=int.是呀
글쎄요=int.可能是;也許
글쓰기=寫字活動
글씨=字
글자=n.字
긁다=抓
금=黃金
금강산=n.金剛山,(在朝鮮境內的江原道,是朝鮮半島首屈一指的名山)
금고=n.今昔
금년=n.今年
금메달=n.金質獎章
금방=adv.剛剛
금세=n.今世,現世
금액=n.金額
금연=n.禁煙
금요일=n.星期五
금지=n.禁止
금지되다=禁止(被)
금지하다=禁止
금하다=v.說價,喊價
급=級
급격히=adv.急劇
급속히=急速地
급증하다=猛增
급하다=adj.急
급히=急速
긋다=劃
긍정적=肯定的
기13=13期
기23=23期
기간=n.期間
기계=n.機器
기관=n.機器
기구=工具
기기13=機器,車
기념=n.紀念
기념일=紀念日
기념하다=紀念
기능=技能
기다=爬
기다리다=v.等待
기대=n.期待
기대다=n.倚,倚靠
기대되다=期待,指望
기대하다=期待
기도=n.祈禱
기도하다=祈禱
기독교=n.基督教
기둥=n.柱,柱子
기록=n.記錄
기록되다=記錄(被)
기록하다=記錄
기르다=留(鬍子,頭髮);培養,養
기름=n.油
기막히다=adj.氣塞,氣堵住,喘不過氣來
기법=n.方法(講究技巧的)
기본=n.基本
기본적=基本的
기분=n.心情,氣氛
기뻐하다=v.開心
기쁘다=adj.高興
기쁨=高興
기사=n.司機,新聞報導
기성08=奇怪的聲音,既成
기성세대=老一代
기숙사=n.宿舍
기술=技術
기술자=技術者
기술하다=記述
기억=n.記憶
기억나다=記得
기억되다=被記住
기억하다=記憶
기업=n.企業
기업인=企業家
기여=n.貢獻
기여하다=貢獻
기온=n.氣溫
기운=力氣
기울다=adj.傾,傾斜,歪斜
기울이다=v.歪斜,傾斜,貫注,傾注
기원=起源
기자=n.記者
기적=n.奇跡
기준=基準
기차=n.火車
기초=基礎
기초적=初等,基礎的
기초하다=基礎
기침=n.咳嗽
기타=吉他
기호=n.記號,符號
기혼=n.已婚
기회=n.機會
기획=n.規劃,計畫
기후=n.氣候
긴급=n.緊急
긴장=n.緊張
긴장감=緊張感
긴장되다=緊張,發緊
긴장하다=緊張
길=n.路
길가=n.路邊,路旁
길거리=n.街道
길다=adj.長
길어지다=v.變長
길이=n.長度
김=n.紫菜
김밥=n.紫菜飯
김치=n.泡菜
김치찌개=泡菜火鍋
김포공항=金浦機場
깊다=adj.深
깊숙이=adv.深邃,幽深,深深地
깊이=深深地
까다=v.瘦削
까닭=n.緣故
까만색=n.黑色
까맣다=深黑色
까먹다=v.嗑
까치=n.喜鵲
깍두기=n.泡蘿蔔塊(泡菜的一種)
깎다=v.殺價
깔끔하다=adj.精練,俐落
깔다=舖
깔리다=v.散開,攤平
깜빡=adv.明滅
깜짝=吃驚
깡패=n.強盜集團,匪幫
깨끗이=乾淨地
깨끗하다=adj.乾淨
깨끗해지다=洗淨度
깨다=v.睡醒
깨닫다=明白
깨달음=醒悟
깨뜨리다=v.打破
깨소금=n.芝麻鹽
깨어나다=v.醒,清醒
깨어지다=v.破碎
깨우다=v.叫醒
깨지다=v.粉碎,打碎
꺼내다=v.拿出來
꺼지다=v.熄滅
꺾다=v.折斷
껌=n.口香糖
껍질=n.皮
꼬리=n.尾巴
꼬마=n.小鬼(稱呼可愛的小孩)
꼭=adv.一定
꼭대기=頂部
꼴=n.樣子,熊樣兒
꼼꼼하다=adj.細心的
꼼짝=adv.彈的樣子
꼽히다=v.數,數一數二,屈指可數
꽂다=插
꽃=n.花
꽃씨=n.花籽
꽃잎=n.花瓣
꽉=adv.滿的樣子
꽤=相當
꾸다=做(夢);借
꾸리다=v.包,捆,打
꾸미다=佈置
꾸준하다=adj.堅持不懈,孜孜不倦
꾸준히=堅持不懈地
꾸중=責備
꿀=n.蜂蜜
꿈=n.夢
꿈꾸다=phr.幻想,做夢
꿈속=n.夢中
끄다=v.關(燈,蠟燭等)
끄덕이다=點頭
끈=n.繩子
끊기다=斷,斷絕,中斷
끊다=v.斷絕
끊어지다=斷,停
끊임없다=連續不斷
끊임없이=不斷地
끌다=吸引;拖,拖延
끌리다=被吸引
끌어당기다=v.拉進來,拉攏
끓다=沸騰
끓이다=使沸騰
끝=末端
끝나다=v.結束
끝내=終於
끝내다=v.結束
끝없다=adj.無限的
끝없이=adv.無邊無際
끼=n.頓
끼다=v.籠罩,彌漫
끼어들다=插入
끼우다=插,夾
나=pron.我
나가다=v.出去
나누다=v.分,分成,劈開
나누어지다=分散
나뉘다=被分開
나다=v.出;空出
나들이=n.串門
나라=n.國家
나란히=adv.並排
나르다=v.搬運
나름=n.要看怎麼
나머지=剩下的
나무=n.樹木
나물=蔬菜
나뭇가지=n.樹枝
나뭇잎=n.樹葉
나비=蝴蝶
나빠지다=adj.變壞
나쁘다=adj.不好,壞
나서다=站出來
나아가다=v.前進
나아지다=v.好轉
나오다=v.出來
나이=n.年齡
나중=n.最後
나침반=n.羅盤
나타나다=出現
나타내다=出現,顯示
나흘=n.四天
낙엽=n.落葉
낚시=n.釣鉤
낚시꾼=n.釣魚的人
낚싯대=釣竿
난리=n.戰亂,離亂,兵荒馬亂,亂七八糟
난방=n.供暖
날=n.天,日
날개=翅膀
날다=褪色
날리다=放飛
날씨=n.天氣
날아가다=飛走
날아다니다=v.飛來飛去
날아오다=飛來
날짜=n.日子,日期
날카롭다=adj.犀利的
낡다=舊
남=n.男
남기다=使剩下
남녀=男女
남다=留下
남대문=n.南大門
남대문시장=南大門市場
남동생=n.弟弟
남매=n.兄妹,兄弟姊妹
남미=n.南美洲
남부=南部
남북=n.南北,南和北
남산=n.南山
남성=男性
남자=n.男性,男人
남쪽=n.南邊
남편=n.丈夫
남학생=女同學
납득하다=v.接受
낫다=強
낭비=n.浪費
낮=n.白天
낮다=adj.低,矮
낮아지다=v.落,下降
낮추다=v.降低,貶低
낯설다=陌生
낱말=單詞
낳다=adj.更好
내=n.煙
내과=內科
내내=一直
내년=n.明年
내놓다=拿出來
내다=開路;交;拿出
내다보다=展望
내달=n.下個月
내려가다=下去
내려놓다=放下
내려다보다=俯視
내려오다=下來
내려지다=v.掉下來
내리다=v.下(雨)
내밀다=伸出
내버리다=v.拋棄,扔掉,丟開
내보내다=v.放出去,拿出去,送出去
내부=內部
내쉬다=v.吐出,呼氣
내외=夫婦
내용=n.內容
내용물=n.內容物
내일=n.明天
내적=n.內部的,內地的
내주다=拿出
내지=乃至
내후년=明後年
냄비=n.平底鍋(比如不黏鍋)
냄새=n.氣味
냇물=n.小河
냉동=n.冷凍,凍
냉면=n.冷面
냉방=n.冷炕
냉장고=n.冰箱
너=你
너머=多
너무=adv.太(too)
너무나=adv.太,過於
너희=你們
넉=num.四
넉넉하다=adj.富餘,足夠
널리=廣泛地
넓다=adj.寬
넓어지다=v.廣闊
넓히다=開闊
넘겨주다=轉交
넘기다=v.弄過去,移交
넘다=v.超過
넘어가다=上當
넘어뜨리다=推倒
넘어서다=克服
넘어오다=v.轉向,倒向
넘어지다=v.跌倒
넘치다=溢出
넣다=v.裝進去,放進去
네=num.(回答的時候)是
네거리=n.十字街,十字路
넥타이=領帶
넷=num.四
넷째=num.第四
녀석=n.傢夥,小子
년=n.年
년대=n.年代
년도=n.年限,年代
년생80=80年生
노동=n.勞動
노동자=勞動者
노란색=n.黃色
노랗다=黃色
노래=n.歌曲
노래방=n.練歌房
노래하다=v.唱
노랫소리=歌聲
노력=n.努力
노력하다=v.努力
노선=路線
노인=n.老人
노트=筆記本
녹다=融化
녹색=n.綠色
녹음=n.錄音
녹음하다=錄音,灌
녹이다=v.熔化
녹차=n.綠茶
녹화=綠化
논=n.水田,稻田
논리=n.論理,邏輯
논리적=adj.邏輯的
논문=n.論文
논의하다=討論
논쟁=n.論爭
논하다=談
놀다=v.玩
놀라다=v.驚訝
놀랍다=驚人
놀리다=v.動,動一動
놀이=n.遊戲
놀이터=遊戲場
놈=n.傢伙
농구=n.籃球
농담=玩笑
농민=農民
농부=農夫
농사=農事
농사일=n.農活兒
농사짓다=種莊稼,種田
농산물=n.農產品
농업=n.農業
농장=n.農場
농촌=農村
높다=adj.高
높아지다=v.增長
높이=高度
높이다=提高
놓다=v.放下
놓아두다=v.放置,擱置
놓이다=放下
놓치다=v.錯失
놔두다=聽他所為
뇌=腦
누구=adv.誰(who)
누나=n.姐姐(男稱女)
누르다=v.按
눈=n.雪,眼睛
눈가=n.眼邊
눈감다=phr.瞑目,斷氣,死
눈길=視線
눈동자=n.瞳孔
눈뜨다=phr.睜眼
눈물=n.眼淚
눈병=n.眼病
눈부시다=adj.耀眼
눈빛=n.雪色
눈썹=n.眉毛
눈앞=眼前
눕다=躺下
뉴스=新聞
뉴욕=紐約
느껴지다=隨感
느끼다=v.感受,察覺
느낌=n.感覺
느리다=緩慢
늑대=n.狼的一種
늘=adv.常常
늘다=v.增多,增長
늘리다=增加
늘어나다=v.增加
늘어놓다=v.擺放
늘어서다=v.排列成行
늘어지다=v.變長
늙다=老
능동적=主動的
능력=n.能力
늦가을=晚秋
늦다=adj.晚
늦어지다=v.遲誤
다=adv.都
다가가다=靠近
다가서다=v.靠近,站進
다가오다=靠近
다녀가다=v.來過
다녀오다=v.去了又回來
다니다=v.來住
다듬다=v.打扮
다루다=v.使用
다르다=adj.不同
다른=另外,異,別的
다름없다=adj.全一樣的
다리=n.橋,腿
다만=只有
다방=咖啡廳
다섯=num.五
다섯째=num.第五
다소=多少
다수=n.多數
다시=adv.再,重新
다양성=n.多樣性
다양하다=adj.多種多樣的
다양해지다=多樣,花哨
다음=n.然後
다이어트=n.減肥
다정하다=adj.親切的
다지다=v.打緊,壓結實,壓緊
다짐하다=下決心
다치다=v.受傷,碰,騷擾,挑釁
다투다=v.吵嘴
다툼=n.鬥爭,角鬥
다하다=盡
다행=n.僥倖,幸虧,幸好
다행히=adv.幸好
닥치다=v.臨近,迫近
닦다=v.擦
단=捆
단계=n.階段
단골=n.熟客,常客
단단하다=健壯
단독=n.單獨,獨自
단맛=n.甜味兒
단순=n.單純,簡單
단순하다=單純
단순히=adv.單純地
단어=n.單詞
단위=n.單位
단점=n.缺點
단지=adv.僅僅,罐
단체=n.團體
단추=扣子
단편=n.短篇
단풍=n.楓葉
닫다=v.關
닫히다=被關
달=n.月亮
달걀=雞蛋
달다=甜;吊;燙;稱(重量)
달라지다=變化
달래다=v.說服,勸,撫慰
달러=n.美元
달려가다=v.跑過去
달려들다=v.撲上去,沖上去
달려오다=v.跑過來
달력=n.月歷
달리=adv.另,另外
달리기=n.跑步
달리다=掛
달빛=n.月光
달아나다=逃跑
닭=雞
닭고기=雞肉
닮다=adj.(長得)像
담=圍牆
담그다=v.浸,泡
담기다=v.盛,裝,內蘊
담다=盛,裝
담당=n.擔當,負擔,承擔
담당자=n.負責人
담당하다=擔任
담배=n.(香)煙
담요=n.毯子
담임=n.擔任,擔當
답=n.答,回答,解答
답답하다=悶
답변=n.答辯,回答
답장=n.回信
답하다=回答,答覆
닷새=n.五天
당근=n.胡蘿蔔
당기다=拉,拖
당당하다=理直氣壯
당분간=adv.暫且,臨時
당시=當時
당신=pron.你,您(第二人稱代詞)
당연하다=adj.當然,自然
당연히=當然
당장=當場
당하다=遭受
당황하다=adj.慌忙
닿다=v.接觸,觸及,到達
대=n.台,代,歲
대가=n.代價
대강=n.大綱
대개=大概
대구=n.鱈魚
대규모=n.大規模
대기=n.大氣
대기업=n.大公司
대기하다=等待
대낮=白晝
대다=靠近
대다수=n.大多數
대단하다=了不起
대단히=adv.相當,非常
대답=n.回答
대답하다=v.回答
대도시=n.大城市
대략=大約
대량=大量
대로=照
대륙=大陸
대문=n.本文,正文,大門
대부분=n.大部分
대비=n.對比
대비하다=較量
대사=n.臺詞
대사관=n.大使館
대신=n.替代,代替
대신하다=代替
대여섯=num.五六(個)
대응=n.相對,對立
대응하다=對應
대장=n.鐵匠
대접=接待
대접하다=招待
대중=n.大眾
대중교통=n.大眾交通
대중문화=流行文化
대중적=大家的
대책=對策
대처하다=針對
대체=adv.到底
대체로=n.替代,交替
대출=n.出借,出租
대충=adv.大概
대통령=總統
대표=n.代表
대표적=n.代表性
대표하다=代表
대하다=對待
대학=n.大學
대학교=n.大學
대학교수=教授
대학생=大學生
대학원=n.研究生院
대한민국=大韓民國
대합실=候車室
대형=n.隊形
대화=n.對話
대화하다=對話
대회=n.大會
댁=n.宅
댐=n.堤壩
더=adv.更多
더러워지다=污泥,骯髒
더럽다=adj.髒
더불다=v.跟,同,一起
더욱=adv.更加
더욱더=adv.更,更加
더욱이=adv.更加,更為
더위=n.暑熱,指夏季的酷熱
더하다=v.更加,更為,加上
덕=恩惠
덕분=adv.多虧
던지다=投
덜=少
덜다=v.減,減少
덥다=adj.熱
덧붙이다=v.附帶,跨
덩어리=塊
덮다=v.蓋上
덮이다=v.被覆蓋,被掩蓋
데=地方
데려가다=v.帶走
데려오다=v.帶來
데리다=v.帶領
데우다=v.熱
데이트=n.約會
도=n.道,朝鮮半島由8個道組成,類似於中國的省
도구=道具
도달하다=到達,達成
도대체=adv.到底,究竟
도덕=n.道德
도둑=n.小偷,盜賊
도로=n.馬路,道路;指比較寬的馬路
도리어=adv.反而
도마=n.案板,菜板
도망=n.逃亡,逃走,逃跑
도망가다=出走,逃亡
도망치다=逃亡
도서관=n.圖書館
도시=n.城市
도시락=n.便當,飯盒
도심=n.市中心
도와주다=v.幫忙,指幫別人
도움=n.幫助
도움말=幫助
도입=n.導入,採用,吸取
도자기=n.陶瓷,瓷器
도저히=adv.到底,萬萬
도전=n.挑戰
도중=途中
도착=n.到達
도착하다=v.到達
도쿄동경=東京,Tokyo
독감=n.重感冒
독립=n.獨立
독립하다=獨立
독서=n.讀書
독일=德國
독일어=n.德語
독창적=獨創性
독특하다=adj.獨特
독하다=adj.狠毒
돈=n.錢
동=洞
동그랗다=圓
동화책=童話書
되돌아보다=回顧
두세=兩三
두어=num.兩三個
뒷모습=n.背影
뒷산=後山
들다=v.住(旅館),花費,舉起
들려오다=傳來
듯=好像,似
듯싶다=adj.好像是,像是
따스하다=adj.溫暖,暖和
딸아이=妞,小女
땅속=地下
떠나오다=離開
마구=亂
마누라=n.老婆
마늘=n.大蒜
마당=院子
마디=n.節
마땅하다=adj.理所應當
마라톤=n.馬拉鬆
마련=n.準備
마련되다=準備,籌備
마련하다=v.備好
마루=頂部
마르다=瘦
마리=n.只(動物量詞包括鳥類,魚類和昆蟲)
마무리=n.成,結束
마사지=n.按摩
마시다=v.喝
마약=n.毒品
마요네즈=n.沙拉醬
마을=村子
마음=n.心靈,心情
마음가짐=心情
마음껏=adv.盡情
마음대로=隨便
마음먹다=v.下決心
마음속=n.心裡
마음씨=心眼
마이크=n.麥克風
마주=面對面
마주치다=相撞,碰撞
마중=n.迎接,出迎
마지막=最後
마찬가지=n.同樣
마찰=摩擦
마치=adv.仿佛
마치다=v.結束
마침=adv.恰好
마침내=adv.終於
마크=n.商標
마흔=num.四十
막=剛要
막걸리=n.馬格利酒(米酒的一種)
막내=老么
막다=v.堵住,堵塞
막상=adv.真地…
막히다=被擋住
만=滿
만나다=v.見面
만남=遇見
만두=包子,水餃
만들다=v.製造
만들어지다=產生,製成
만만하다=adj.軟,鬆軟
만세=萬歲
만약=萬一
만일=萬一
만점=n.滿分
만족=n.滿足,滿意
만족스럽다=adj.滿足,滿意
만족하다=滿足
만지다=碰
만큼=aux.表示程度
만하다=n.晚夏
만화=n.漫畫
만화가=n.漫畫
많다=adj.多
많아지다=v.增,增多
많이=adv.多
말=馬;底
말기=n.褲腰,裙腰
말다=卷
말리다=v.弄幹,晾乾
말씀=n.話,言語
말씀드리다=v.年長的人說話
말씀하다=說,言,稟白
말없이=adv.一言不發,不聲不響,默默地
말투=n.語氣,口氣
말하다=v.說話
맑다=adj.(天氣)晴朗,(水)清澈
맘=n.心
맘대로=隨心所欲
맛=n.味道
맛보다=品嘗
맛없다=adj.不好吃
맛있다=adj.好吃
망설이다=v.猶豫
망원경=n.望遠鏡
망치다=v.弄壞,搞壞,搞糟
망하다=v.完蛋,倒閉
맞다=adj.準確
맞서다=對抗
맞은편=n.對面
맞이하다=迎接
맞추다=對上
맡기다=存放,託付
맡다=v.承擔
매=棒子
매너=n.禮節
매년=n.每年
매다=捆
매달=n.每個月
매달다=v.系,掛
매달리다=v.糾纏,掛在,系在
매력=n.魅力
매번=adv.每次
매스컴=n.公眾媒介
매우=adv.非常,十分
매일=adv.每天
매장=n.售貨櫃檯,埋葬,每張
매주=n.每週
매체=n.媒體
맥주=啤酒
맨=最,光著
맵다=adj.辣
맺다=v.結交
머리=n.頭,頭髮
머리말=n.序,序言,前言,卷頭語
머리카락=頭髮
머리칼=頭髮
머릿속=腦子裡
머무르다=停留
머물다=v.停留
먹고살다=v.做生計
먹다=v.吃
먹이=n.飼料,餌
먹이다=餵養
먹히다=v.被吃,需要
먼저=adv.先(first),表示順序
먼지=n.塵土,灰塵
멀다=adj.遠
멀리=遠
멀어지다=離心,漸行漸遠
멈추다=停止
멋=n.風姿
멋있다=adj.帥氣,瀟灑
멋지다=漂亮
멍멍=adv.汪汪(狗叫聲)
멎다=停止
메뉴=n.菜單
메다=背,扛
메모=n.記錄
메시지=n.資訊
메우다=v.填,填充,填平
메일=郵件,電郵
며느리=n.媳婦
며칠=n.幾天
면=n.棉布或棉線
면담=n.面談
면적=面積
면접=n.面試
면하다=免
멸치=n.鯷魚,海蜒
명=n.名
명단=n.單
명령=命令
명령어=n.命令
명예=n.名譽
명의=n.名義,名醫
명절=n.節日
명칭=n.稱
명함=n.片
명확하다=明確
몇=adv.幾(後接量詞)
몇몇=pron.幾個,某些
몇십=幾十
모=n.某,母,秧,毛,棱角
모금=n.口
모기=n.蚊子
모니터=n.監聽員,監察員
모델=n.模特
모두=adv.全部
모든=所有
모래=沙子
모레=n.後天
모르다=v.不知道
모범=n.模範
모색하다=v.摸索
모습=n.樣子
모시다=陪
모양=n.樣子
모여들다=v.聚集,聚攏
모으다=v.收集
모이다=v.聚集,收集
모임=n.聚會
모자=n.帽子
모자라다=v.不足
모조리=adv.全部
모집=n.招,招募
모집하다=招募
모처럼=adv.特地
모퉁이=n.角落
목=n.脖子
목걸이=n.項鍊,項圈
목록=n.目錄
목사=n.牧師
목소리=嗓音
목숨=n.命,人或者動物的生命
목요일=n.星期四
목욕=n.洗澡
목욕탕=澡堂
목적=n.目的
목표=n.目標
몰다=駕駛
몰래=悄悄地
몰려들다=v.被趕出去
몰려오다=v.被趕出來
몸=n.身體
몸매=n.身姿,身段
몸무게=體重
몸살=n.病痛,四肢酸痛
몸속=n.體內
몸짓=n.身體的動作
몸통=n.身軀,塊頭
몹시=很
못=adv.表示否定;n.釘子,湖
못되다=adj.不夠,不足
못생기다=adj.難看,長得醜
못지않다=不亞於
못하다=adj.不能,不及
묘사=n.描寫
묘사하다=描寫,描述
무=n.蘿蔔
무겁다=重
무게=n.重量
무관심=n.不關心
무관심하다=adj.關心
무궁화=n.無窮花,木槿;無窮花是韓國國花
무기=n.武器
무너지다=v.垮,塌,垮臺
무늬=n.紋理
무대=n.舞臺
무더위=酷暑
무덤=墳墓
무덥다=adj.(天氣)熱
무려=adv.足有,多達
무렵=時候
무료=n.免費
무릎=n.膝蓋
무리=群
무리하다=adj.毫無道理,超過正常的界限
무사하다=無事,平安
무섭다=adj.可怕,恐怖
무슨=adv.什麼
무시하다=無視
무어=pron.什麼,何
무엇=adv.什麼(what)
무역=貿易
무용=n.舞蹈
무용가=n.舞蹈
무의미하다=無意義
무조건=adv.無條件
무지개=n.虹,彩虹
무책임하다=不負責任
무척=adv.非常
묵다=v.捆紮
묶다=綁
묶이다=v.綁,限制
문=n.門
문구=n.文句,句子
문득=adv.恍然,頓時,驟然間
문밖=n.門外
문법=文法
문서=n.文件,公文
문자=文字
문장=n.文章
문제=n.問題
문제되다=成問題
문제점=問題
문학=n.文學
문학적=文學的
문화=n.文化
문화재=n.文化遺產
문화적=有文化的
묻다=v.問;沾到
묻히다=v.埋葬
물=n.水
물가=n.物價
물건=n.東西,物
물결=水波
물고기=n.魚
물기=水氣
물다=v.咬
물러나다=v.讓開,躲開
물론=n.當然
물리학=物理學
물속=水中
물어보다=v.問
물음=n.提問
물질=物質
물질적=n.物質的
물체=物體
뭘=pron.什麼,무엇을的縮寫
뭣=什麼
미=n.美
미국=n.美國
미끄러지다=v.滑,滑倒
미끄럽다=adj.滑,光滑,平滑
미니=n.小型的
미디어=n.媒體
미래=n.未來
미루다=v.推遲
미리=adv.事先,預先
미만=n.未滿
미사일=n.導彈
미소=微笑
미술=n.美術
미술관=n.美術館
미스=n.失敗,失策
미안하다=adj.對不起
미역=n.海帶
미용실=n.美容室
미움=n.嫌棄
미워하다=恨
미인=n.美人,美女
미처=adv.來不及
미치다=瘋
미터=公尺
미팅=n.相會,相遇
미혼=n.未婚
민간=民間
민속=民俗
민족=n.民族
민주=n.民主
민주주의=n.民主主義
민주화=n.民主化
믿다=v.相信;n.믿음(n.信任)
믿어지다=見信
믿음=相信
밀가루=n.麵,麵粉
밀다=推
밀리다=v.推遲
밀리미터=毫米
밀접하다=adj.密切
밉다=難看
및=adv.與,和,以及
밑=n.底
밑바닥=n.底,底面
바=n.粗繩
바가지=n.瓢
바구니=n.籃子
바깥=n.外面
바깥쪽=外邊
바꾸다=v.換
바뀌다=被調換
바나나=n.香蕉
바늘=n.針
바다=n.大海
바닥=n.底板,底部
바닷가=n.海邊
바닷물=n.海水
바라다=希望
바라보다=望
바람=n.風
바람직하다=adj.可取的,明智的
바로=adv.正好
바로잡다=v.弄直,扶正
바르다=v.塗(藥),adv.端正的
바보=白癡
바쁘다=adj.忙
바싹=緊緊地
바위=岩石
바이러스=n.病毒
바이올린=小提琴
바지=n.褲子
바치다=繳納
바퀴=輪子
바탕=底子
박=n.瓢,葫蘆,匏瓜
박다=打
박물관=n.博物館
박사=n.博士
박수=拍手
박스=n.箱子
박히다=v.砸,盯視,固定
밖=n.外
반=半
반갑다=adj.高興
반기다=歡迎
반대=n.相反,反對
반대편=n.對面
반대하다=反對
반드시=adv.必須
반말=n.用非敬語說話
반면=n.另一方面
반발=n.彈回
반복되다=反覆,重複
반복하다=重覆
반성=n.反省
반성하다=v.反省
반영하다=反映
반응=n.反應
반장=n.班長
반죽=n.和,揉(麵)
반지=n.戒指,指環
반짝거리다=明亮
반짝이다=v.晶明,光閃閃
반하다=v.看上,迷住
받다=v.收,接收
받아들이다=吸收
받침=n.托子,托兒
발=n.腳
발가락=腳趾
발걸음=腳步
발견=n.發現
발견되다=被發現
발견하다=發現
발길=腳步
발끝=n.腳尖
발달=n.發達,發展
발달되다=擴展
발달하다=發達
발등=n.腳背
발레=n.芭蕾舞
발목=n.腳脖子
발바닥=n.腳掌,腳底
발생=n.發生
발생하다=發生
발음=n.發音
발음하다=發音
발자국=n.腳印
발전=n.發展
발전되다=發展,暢茂
발전하다=發展
발톱=n.腳指甲
발표=n.發表
발표되다=問世,發表,揭曉
발표하다=發表
발휘하다=v.發揮
밝다=adj.(天)亮
밝아지다=發亮
밝혀내다=探明
밝히다=闡明
밟다=踩
밤=n.夜
밤낮=n.晝夜,日夜
밤늦다=夜深
밤새=夜間
밤새다=熬夜
밤새우다=熬夜
밤색=n.褐色,栗色
밤중=半夜
밤하늘=n.夜空
밥=n.飯
밥맛=n.飯味
밥상=n.飯桌
밥솥=n.飯鍋
방=n.房間
방금=adv.剛才
방면=n.方面
방문=n.藥方
방문하다=v.訪問
방바닥=地板
방법=n.方法
방송=n.廣播,播放
방송국=n.廣播局
방송사=n.廣播電臺,放送局
방송하다=選播
방식=n.方式
방안=n.房內
방울=鈴;珠
방지=n.防止
방지하다=v.防止
방학=n.假期,放假
방해=n.防礙
방해하다=打擾
방향=方向
밭=田地
배=n.肚子,梨
배경=n.背景
배고프다=adj.肚子餓
배구=排球
배꼽=n.肚臍
배다=密密的;浸透;懷孕
배달=n.配送,發送
배드민턴=n.羽毛球
배부르다=肚子飽
배우=n.演員
배우다=v.學習
배우자=n.配偶
배추=白菜
배추김치=白菜泡菜
배치=n.佈置
백=n.白,白色
백두산=長白山
백색=n.白色
백성=n.百姓
백인=白人
백제=百濟
백화점=n.百貨店
뱀=n.蛇
뱃사람=n.船夫,船員
뱉다=呈
버려지다=丟掉
버릇=n.習慣
버리다=v.丟棄
버섯=n.蘑菇
버스=n.大客車,公車
버터=n.黃油,奶油
버튼=按鈕,扣子
버티다=v.對抗,反抗
번=n.回
번개=n.閃電
번거롭다=adj.繁瑣的
번역=n.翻譯
번역하다=翻譯
번지=n.門牌號
번째=次,回
번호=n.號碼
벌=n.罰,處罰
벌금=n.罰款
벌다=v.掙(錢)
벌떡=adv.突然,猛然,一下子
벌레=n.蟲子
벌리다=v.張開(嘴)
벌써=adv.早就,已經
벌어지다=v.裂開
벌이다=攤開
범위=n.範圍
범인=n.凡人
범죄=n.犯罪
법=n.法
법률=n.法律
법원=n.法院
법적=n.法律的
법칙=n.法則
벗기다=脫,卸下
벗다=v.脫
베개=n.枕頭
베다=砍
베이징북경=北京,Beijing
벤치=n.長椅,長凳
벨트=n.傳送帶,皮褲帶
벼=n.稻子
벽=牆
변경=n.變更
변동=n.變動
변명=n.狡辯
변신=n.變身,搖身一變
변하다=變
변호사=n.律師
변화=變化
변화되다=變化,化
변화하다=變化
별=星星
별다르다=adj.特別
별도=n.另外
별로=adv.不怎麼,不很
별명=n.綽號
별일=n.特別的事,其他的事
병=n.病
병들다=v.生病,得病
병실=n.病房
병아리=n.小雞
병원=n.醫院
보고=n.報告
보고서=報告書
보고하다=報告
보관=n.保管
보관하다=v.保管
보내다=v.送,派,遞
보내오다=來訊,來函
보너스=n.獎金,獎勵
보다=v.看;更
보도=n.報導
보도되다=報導
보도하다=報導
보라색=n.青紫色
보람=n.意義
보름=n.十五日,十五號
보리=大麥
보살피다=照應
보상=n.補償
보수=n.報酬
보수적=保守的
보안=n.保安
보완하다=v.彌補,補充
보이다=被看
보자기=n.小包,包裹,小包袱
보장=n.保障,保證
보장되다=保藏
보장하다=保障
보전=n.保存,保全
보조=n.步調
보존=n.保存
보존하다=保存
보충하다=補充,填補
보통=adv.普通地,通常
보편적=adj.普遍的
보험=n.保險
보호=n.保護
보호되다=保護
보호하다=保護
복=n.福
복도=走廊
복사=n.複寫,複印
복사하다=複印
복숭아=桃子
복습=n.復習
복습하다=溫習功課
복잡하다=adj.複雜
볶다=v.炒
볶음=n.炒(菜)
볶음밥=炒飯
본=n.榜樣
본격적=n.正式
본래=本來
본부=n.本部,總部
본사=n.總社
본성=n.本性
본인=n.本人
본질=n.本質
볼=火
볼링=n.保齡球
볼일=n.要做的事
볼펜=n.原子筆
봄=n.春天
봉사=n.無償服務,奉獻
봉사하다=服務,奉獻
봉지=袋子
봉투=n.信封
뵈다=v.趨前
뵙다=會見
부=n.部
부근=附近
부끄러움=害羞
부끄럽다=adj.害羞的
부담=n.負擔
부담하다=負擔,負責
부대=n.部隊
부동산=n.房地產
부드럽다=adj.溫和
부딪치다=v.衝撞
부딪히다=v.撞,衝撞
부러워하다=羨慕
부러지다=斷
부럽다=羨慕
부르다=v.唱,喊
부모=n.父母
부모님=n.父母
부문=部門
부부=n.夫婦
부분=n.部份
부분적=n.部分的,局部的
부산=n.釜山,(韓國第二大城市,港口城市)
부상=n.負傷,受傷
부서=n.部門
부서지다=v.碎,破碎
부엌=n.廚房
부위=n.地方,部位
부인=n.夫人
부자=n.父子,富翁
부작용=n.副作用
부잣집=有錢人
부장=n.部長
부재=n.部件,構件
부정=n.舞弊,不正
부정적=否定的
부정하다=否定
부족=n.部族
부족하다=adj.不足
부지런하다=adj.勤奮
부지런히=勤快
부채=n.扇子
부처=n.佛,佛像
부치다=v.郵寄
부친=爸爸
부탁=n.囑託
부탁하다=v.拜託
부품=n.配件,部件
부피=n.體積
부회장=副會長
북=北
북부=北部
북쪽=北邊
북한=n.北韓
분=n.位
분노=n.憤怒
분량=n.分量
분리=分離
분리되다=被分離
분리하다=v.分離
분명=分明
분명하다=adj.明顯的
분명해지다=愈辯愈明
분명히=分明
분석=n.分析
분석하다=分析
분야=領域
분위기=n.氣氛
분주하다=adj.忙碌,奔波
분포하다=分佈
분필=n.粉筆
분홍색=粉紅色
불=n.火
불가능하다=不可能
불가피하다=adj.不可避免的
불고기=n.燒烤,烤肉
불과=adv.過
불과하다=adv.僅僅,不過(如此)
불교=n.佛教
불구하다=v.不顧
불꽃=火花
불다=v.吹
불러일으키다=v.呼喚,號召
불리다=被叫
불리하다=adj.不利的
불만=n.不滿
불법=不法;佛法
불빛=火花
불쌍하다=adj.可憐
불안=n.不安
불안하다=不安
불어오다=刮來
불이익=損壞
불편=n.不便,不舒服
불편하다=adj.不方便
불평=n.不滿,委屈
불평등하다=adj.平等
불필요하다=adj.不必要
불행=n.不幸
불행하다=不幸
불확실하다=adj.確實
붉다=adj.紅色的
붐비다=adj.混亂
붓다=腫
붙다=考上,貼
붙들다=v.抓
붙이다=v.黏貼
붙잡다=v.抓,抓緊
붙잡히다=v.被抓住,被揪住
브랜드=n.商標
블라우스=n.寬大的罩衫
비=n.雨
비교=n.比較
비교적=比較的
비교하다=v.比較
비극=n.悲劇
비기다=平手
비난=n.刁難
비누=n.肥皂
비닐=塑膠
비닐봉지=塑膠袋
비다=空著
비둘기=n.鴿子
비디오=n.錄影帶
비로소=adv.方才
비롯되다=v.源自于,始於
비롯하다=以…為首
비만=n.雨
비명=n.碑銘
비밀=n.秘密
비바람=n.風雨
비비다=v.拌
비빔밥=n.拌飯
비상=n.非常,緊急
비서=n.秘書
비슷하다=adj.相似
비싸다=adj.(價格)貴
비용=n.費用
비우다=使空
비웃다=v.嘲笑,譏笑
비율=n.比率
비중=n.比重
비추다=照
비치다=照
비키다=v.讓開,躲開
비타민=維他命
비판=n.批評
비판적=adj.批判的
비판하다=批評
비하다=比較
비행=n.惡行,胡作非為
비행기=n.飛機
비행장=n.飛機場
빌다=祈求
빌딩=n.大廈
빌리다=v.借,從別人處借來
빗=梳子
빗물=n.雨水
빗방울=n.雨點兒,雨滴
빗줄기=n.雨滴
빚=債
빛=n.光
빛깔=顏色
빛나다=adj.發光
빠뜨리다=使沈入
빠르다=快
빠져나가다=留後路,外流,脫開
빠져나오다=脫漏
빠지다=v.陷入
빨간색=n.紅色
빨갛다=紅
빨다=v.洗,含在嘴裡
빨래=n.髒衣服(需要洗的)
빨리=adv.快地
빵=n.麵包
빼놓다=v.漏掉,拉下
빼다=v.抽出
빼앗기다=v.搶奪,…奪取
빼앗다=v.搶奪
뺏다=v.奪掉,搶奪
뺨=n.兩腮
뻔하다=adj.明顯的,清楚的
뻗다=伸展
뼈=骨骼
뽑다=v.拔(頭髮),抽(血),選拔
뽑히다=v.抽起,拔(被)
뿌리=n.根
뿌리다=放射
뿌리치다=v.拂,甩
뿐=只
사=n.私
사건=n.事件,案件
사계절=n.四季
사고=n.事故,思考
사과=n.道歉,蘋果
사과하다=v.道歉
사귀다=v.結交
사기=n.瓷器
사나이=n.男子
사냥=n.打獵,狩獵
사다=v.購買
사들이다=v.買進,購辦
사라지다=v.消失
사람=n.人
사랑=愛
사랑스럽다=adj.可愛
사랑하다=v.愛
사례=事例
사립=私立
사망=n.死亡
사망하다=死
사무=事務
사무소=n.辦事處
사무실=n.辦公室
사무직=辦公職
사물=n.私物
사방=n.四方,四周
사상=n.思想
사생활=n.私生活
사설=n.社論,社評
사소하다=瑣細
사슴=鹿
사실=n.事實
사실상=實則,真是
사십=num.四十
사업=n.事業,工作
사업가=n.企業家,實業家
사업자=n.個體戶,創業者,做事業的人
사용=n.使用
사용되다=被使用
사용자=使用者
사용하다=v.使用
사원=寺院
사월=n.四月
사위=n.女婿
사이=n.中間,間隔
사이사이=中間
사이좋다=adj.關係好
사자=獅子
사장=老闆
사전=n.詞典
사정=n.審定
사진=n.照片
사진기=照相機
사촌=n.堂兄弟,堂姐妹
사춘기=n.青春期
사탕=糖
사투리=n.方言,俚語
사표=n.師範,辭呈
사회=n.社會
사회생활=社會生活
사회자=n.主持人
사회적=n.社會的
사회주의=n.社會主義
사회학=n.社會學
사흘=三天
산=n.山
산길=n.山路
산부인과=n.婦產科
산소=n.氧氣
산속=山中
산업=n.產業
산책=n.散步
살=n.歲
살다=v.住,活
살리다=v.拯救
살림=n.過日子
살아가다=v.生活,活命
살아나다=v.復活,複生
살아남다=v.生存,活下來
살아오다=活過來
살인=n.殺人
살짝=稍微
살펴보다=觀看
살피다=v.察看,觀看,觀察
삶=n.生活,人生
삶다=v.煮
삼=num.三
삼가다=v.謹慎,慎重,小心
삼계탕=n.蔘雞湯
삼국=n.三國,韓國歷史上的三國是高麗,新羅和百濟(고려,신라,백제)
삼다=當作,娶
삼십=n.三十
삼월=n.三月
삼촌=叔叔
삼키다=v.吞下,咽下
상=n.相
상관=n.相關
상관없다=沒關係
상관없이=adv.毫無相干
상금=n.獎金
상담=n.商談
상당=n.相當,合,抵
상당수=大部分
상당하다=adj.相當
상당히=相當
상대=n.對手
상대방=n.對方
상대성=n.相對性
상대적=相對
상대편=n.對方
상류=n.上游
상반기=n.上半期
상상=想像
상상력=n.想像力
상상하다=adj.淒涼
상식=n.常識
상업=n.商業
상인=n.商人
상자=箱子
상점=n.商店
상징적=n.象徵的
상징하다=象徵
상처=n.傷處,傷口
상추=n.生菜
상쾌하다=adj.明快的,輕快的
상태=n.狀態
상표=n.商標
상품=n.商品
상하다=v.受傷
상황=n.狀況,情況
새=pron.新
새기다=v.刻,雕刻
새끼=小畜牲
새다=漏
새로=adv.再一次
새로이=adv.新
새롭다=adj.新穎
새벽=n.淩晨,清晨
새소리=n.鳥聲,鳥語
새우=n.蝦
새우다=v.熬夜
새해=n.新年
색=n.顏色
색깔=n.色彩
색다르다=adj.與眾不同,奇異,特別
색연필=n.彩色鉛筆
샌드위치=n.三明治
생=n.生,生存
생각=n.想法
생각나다=v.想起
생각되다=v.被認為…
생각하다=思考
생겨나다=誕生
생기=n.生氣,朝氣
생기다=v.產生
생명=n.生命
생물=n.生物
생방송=n.現場直播
생산=n.生產
생산되다=生產
생산력=生產力
생산자=n.生產者
생산하다=生產
생선=n.海鮮,新鮮的魚
생신=n.壽辰(敬)
생일=n.生日
생활=n.生活
생활비=n.生活費
생활수준=生活水準
생활용품=n.生活用品
생활하다=生活
생활환경=環境
샤워=n.淋浴
서구=n.西歐,西方
서너=num.三四
서늘하다=adj.涼,涼快
서다=v.站立
서두르다=v.趕忙
서랍=n.抽屜
서로=adv.相互
서류=n.文檔
서른=num.三十
서명=n.署名
서명하다=簽名
서민=n.庶民
서부=n.西部
서비스=n.服務
서서히=慢慢地
서양=n.西方
서양인=n.洋人
서울=n.首爾
서울역=n.首爾站
서적=n.書籍
서점=n.書店
서쪽=西邊
서클=n.社團,小組,組
서투르다=不熟
서툴다=adj.笨拙
석=n.席
석사=碩士
석유=n.石油
섞다=v.混合
섞이다=v.混合(被)
선=n.線
선거=n.選舉
선명하다=adj.鮮明
선물=n.禮物
선물하다=v.送禮物
선배=n.前輩
선생=n.老師
선생님=n.老師
선수=選手
선언하다=宣佈
선원=n.船員
선장=n.船長
선전=n.宣傳
선정하다=v.選定
선진=n.先進
선진국=n.發達國家
선택=n.選擇
선택하다=選擇
선풍기=n.電風扇
선호하다=adj.喜歡
설거지=n.洗碗,指飯後收拾飯桌
설날=n.新年,元旦
설득하다=v.說服
설렁탕=n.雜燴湯
설립하다=建立
설명=n.說明
설명되다=被說明
설명하다=v.說明
설문=n.問卷(用於統計某些資訊的)
설사=n.瀉
설악산=n.雪嶽山(韓國名山,江原道,海拔1708米主峰白青峰)
설치=n.設置
설치되다=設置,安設
설치하다=設
설탕=n.白糖
섬=n.島
섭섭하다=adj.遺憾
섭씨=攝氐
성=島
성격=n.性格
성경=adj.聖經
성공=n.成功
성공적=adj.成功(的)
성공하다=成功
성당=n.教堂(天主教)
성립되다=成立,成事
성립하다=成立
성명=名字
성별=性別
성숙하다=成熟
성실하다=adj.誠實,忠實
성인=n.成年人
성장=n.成長
성장하다=成長
성적=成績
성질=n.脾氣,性格
성함=姓名
세=num.三(用於量詞前),歲(年齡)
세계=世界
세계관=n.世界觀
세계적=n.世界的
세금=n.稅金
세기=世紀
세다=強
세대=n.世代,指的是一個世代的人
세련되다=磨練
세로=縱的
세미나=n.研討會,課堂討論
세상=n.世界,天下
세상에=n.世上,世界,天下,社會
세수=n.洗臉
세우다=v.建立
세워지다=建築,建立,豎立
세월=歲月
세제=n.稅制
세탁=n.洗滌
세탁기=洗衣機
세탁소=n.洗衣店
세트=n.舞臺裝置
섹시하다=adj.性感
센터=n.中心
센티미터=公分
셈=n.數數,計算
셋=num.三,仨
셋째=第三
소=牛
소개=n.介紹
소개되다=被介紹
소개하다=v.介紹
소규모=小規模
소극적=n.消極
소금=n.鹽
소나기=陣雨
소나무=松樹
소녀=少女
소년=n.少年
소득=n.收入,所得
소리=聲音
소리치다=喊叫
소망=希望
소매=n.衣袖
소문=n.傳聞
소문나다=v.漏風聲,走風
소박하다=adj.樸素
소비=n.消費
소비자=n.消費者
소비하다=消費
소설=小說
소설가=n.小說家
소속=n.所屬
소수=n.小數
소스=n.醬,調汁
소시지=n.香腸
소식=n.消息
소아과=n.小兒科
소요되다=需要
소용=n.用處
소용없다=adj.不抵,不濟事
소원=希望
소위=n.所為,行為
소유=n.所有
소유자=n.所有者
소유하다=所有
소음=n.噪音
소재=n.所在
소주=n.燒酒,白酒
소중하다=adj.珍貴
소중히=adv.珍貴
소지품=n.攜帶品
소질=n.素質
소파=n.沙發
소포=n.包裹
소풍=n.兜風,散步
소프트웨어=n.軟體
소형=n.小型
소홀히=adv.疏忽,忽略,忽視
소화=n.消化
소화하다=消化
속=裡面
속담=n.俗語,諺語
속도=n.速度
속마음=n.內心
속삭이다=v.喁喁而語
속상하다=v.傷心
속옷=n.內衣
속이다=騙
속하다=屬於
손=n.手
손가락=n.手指
손길=手
손녀=孫女
손님=n.客人
손등=手背
손목=n.手腕兒
손바닥=手掌
손발=n.手和腳
손뼉=n.鼓掌,拍手
손수=親手
손수건=手帕
손쉽다=adj.容易
손실=損失
손자=n.孫子
손잡다=v.勾著手,拉拉扯扯
손잡이=n.把手
손질=n.修繕
손질하다=修理
손톱=指甲
손해=n.損害
솔직하다=adj.誠實的
솔직히=說實話,
솜=棉花
솜씨=n.才藝,能力
솟다=v.湧出,噴出
송아지=n.牛犢
송이=n.朵,花的量詞
송편=n.蒸糕,鬆糕
쇠=鐵
쇠고기=牛肉
쇼=n.展示會,展覽會
쇼핑=n.購物
수=n.招數,招兒
수건=n.毛巾,手巾
수고=n.辛苦,麻煩
수고하다=受苦
수년=n.年
수단=n.手段
수도=n.水道,自來水
수도권=n.首都範圍
수도꼭지=n.水龍頭
수돗물=n.自來水
수동적=被動
수리하다=v.修理
수만=num.萬
수많다=無數,眾多
수면=n.水面
수명=n.壽命
수박=西瓜
수백=n.百
수상=n.水上
수석=n.首席
수술=n.手術
수시로=n.adv.隨時
수십=n.十
수업=n.上課
수없이=adv.無數
수염=n.鬍鬚
수영=n.游泳
수영장=音{水泳場} n.游泳池
수요=n.需要
수요일=n.星期三
수입=進口
수입되다=進口,收入
수입품=輸入品
수입하다=進口
수저=n.匙和筷
수준=n.水準
수집=n.收集,收藏
수집하다=收集
수천=n.千
수출=n.出口,輸出
수출하다=出口
수컷=n.公的,雄的
수표=n.支票
수필=n.隨筆
수학=n.學習
수행하다=執行,履行,完成
수험생=考生
수화기=耳機,話筒
숙녀=n.淑女
숙소=n.住處,住所
숙이다=v.(把頭)低下
숙제=作業
순간=n.瞬間
순간적=瞬間的
순서=順序
순수=純粹
순수하다=adj.純粹
순식간=n.瞬間,刹那
순위=n.順序
순진하다=adj.天真的,純真的
순하다=adj.溫順
숟가락=n.勺子
술=n.酒
술병=n.酒瓶
술자리=酒席
술잔=n.酒杯
술집=酒家
숨=氣息
숨기다=v.藏,背,隱
숨다=躲
숨지다=v.氣絕,死,死亡
숫자=n.數字
숲=樹叢
쉬다=v.休息
쉰=num.五十
쉽다=adj.容易
슈퍼마켓=n.超市
스님=n.和尚
스무=num.20
스물=num.20
스스로=adv.自行地,獨自地;n.自己
스승=n.師傅,老師
스웨터=毛衣
스위치=n.電燈開關,電動門
스치다=v.擦過
스케이트=溜冰鞋
스케줄=n.計畫,日程
스키=滑雪
스키장=n.滑雪場
스타=n.有名的演員或運動員,名人,明星
스타일=n.風格
스튜디오=n.攝影棚
스트레스=n.壓力(工作或生活帶來的)
스포츠=n.體育
슬그머니=adv.偷偷地
슬쩍=悄悄地
슬퍼하다=悲傷
슬프다=adj.悲傷,悲哀,悲痛
슬픔=悲傷
습관=習慣
습기=n.潮氣,潮濕
승객=n.乘客
승리=n.勝利
승리하다=勝利
승부=n.勝負
승용차=n.轎車
승진=n.(工作職位上的)晉升
시=時;市
시각=n.時刻,時候
시간=n.時間
시계=n.表
시골=n.鄉下,農村
시금치=n.菠菜
시기=時間
시끄럽다=adj.麻煩
시나리오=n.電影劇本
시내=n.市內(繁華地段)
시내버스=市內巴士
시대=時代
시대적=n.時代的
시댁=n.婆家
시도=n.詩
시도하다=試圖
시들다=枯萎
시디롬=光碟,CD-ROM
시리즈=n.系列,叢書
시멘트=n.水泥
시민=n.市民
시부모=n.公婆,舅姑
시선=n.線
시설=n.設施
시스템=n.系統
시아버지=n.公公
시야=n.野,眼界
시어머니=n.婆婆
시외=n.市外
시외버스=公路局車,巴士服務
시원하다=adj.涼爽
시월=n.十月
시위=n.洪水
시인=n.詩人
시일=n.時間,日期
시작=n.開始
시작되다=v.開始
시작하다=v.開始
시장=n.市場,市長
시절=時節
시점=n.起始點
시중=n.侍候,服侍
시즌=n.季節
시집=n.詩集
시집가다=嫁人
시청=n.市政府
시청률=n.收視率
시청자=n.觀眾
시키다=v.指使
시합=比賽
시험=n.考試
식=方式
식구=n.家裡人
식기=n.食器
식다=涼
식당=n.食堂,餐廳
식량=n.糧食,食量
식료품=n.食品
식물=n.植物
식빵=n.麵包
식사=n.吃飯
식사하다=v.吃飯
식생활=n.飲食生活
식욕=n.食慾
식용유=食用油
식초=醋
식탁=n.餐桌
식품=n.食品
식품점=n.食品店
식히다=v.放涼(把熱的東西放置一段時間,使之降溫)
신=鞋子
신고=n.申訴,報警
신고하다=受苦;申告
신규=n.新規定
신기하다=adj.神奇,奇怪
신념=n.信念,信心
신다=v.穿(鞋)
신라=n.新羅(古代的國家名稱)
신랑=n.新郎
신문=n.報紙
신문사=n.報社
신문지=報紙
신발=n.鞋
신부=n.新娘
신분=n.身份
신비=n.神秘
신사=n.紳士
신선하다=adj.新鮮
신설=n.新建設,新建
신세=n.身世
신세대=n.新一代,新世代
신속하다=迅速
신용=信用
신인=n.(娛樂圈)新人
신입생=新生
신제품=n.新產品
신중하다=adj.慎重的
신청=n.申請
신청서=n.申請
신청하다=v.申請
신체=n.身體
신체적=身體的,身體上
신호=信號
신호등=交通號誌
신혼부부=新婚夫婦
신혼여행=新婚旅行
신화=n.神話
싣다=登載
실=n.線
실감=真實感
실내=n.室內
실력=n.實力
실례=n.失禮
실례하다=失禮,對不起
실로=adv.真是,實在
실리다=v.裝載
실망=n.失望
실망하다=adj.失望
실수=n.失誤
실수하다=失手
실습=n.實習
실시=n.實施,即時
실시되다=實施
실시하다=實施
실은=adv.本來,其實
실장=n.老闆,室主任,室長
실정=n.實情
실제=n.實際
실제로=n.實際
실질적=n.實質性的
실천=n.實踐
실천하다=實踐
실체=n.實體
실컷=adv.盡情
실태=n.失態
실패=n.失敗,落敗,栽,翻船
실패하다=失敗
실험=n.實驗
실현=n.實現
실현되다=實現
실현하다=實現
싫다=adj.不願意
싫어지다=討厭
싫어하다=v.不喜歡
심각하다=adj.深刻
심각해지다=嚴重
심다=種
심리=心理
심리적=心理
심부름=n.跑腿
심사=n.心事
심심하다=adj.無聊
심장=n.心臟
심정=n.心情
심판=n.審判
심하다=adj.嚴重
심해지다=加劇,日甚一日
십=num.十
십이월=n.十二月
십일월=n.十一月
싱겁다=淡
싱싱하다=新鮮
싶다=adj.想,有意
싶어지다=想要變成…
싸구려=n.便宜貨,賤賣
싸다=adj.便宜
싸우다=v.戰鬥
싸움=打架
싹=n.芽,萌芽
싼값=n.賤價,廉價
쌀=n.大米
쌍=雙
쌍둥이=n.雙胞胎
쌓다=積累
쌓이다=v.堆稱
썩=adv.很快,立刻,馬上
썩다=腐爛
썰다=v.切
썰렁하다=adj.涼,寒
쏘다=射
쏟다=注
쏟아지다=傾瀉
쓰다=v.寫
쓰다듬다=v.撫摸
쓰러지다=v.倒,倒下,躺倒
쓰레기=n.垃圾
쓰레기통=n.垃圾筒
쓰이다=被使用
쓴맛=n.苦味
쓸다=v.生(鏽)
쓸데없다=adj.無用
쓸데없이=adv.白,虛,值不得
쓸쓸하다=adj.孤獨的,淒涼的
씌우다=v.套,罩,蓋
씨=…先生,女士
씨름=n.摔跤
씨앗=n.種子
씩씩하다=adj.勇壯
씹다=v.嚼
씻기다=v.磨洗(被動)
씻다=v.洗
아=唉,呀,啊哈
아가씨=小姐
아기=n.嬰兒,孩子
아까=adv.剛才
아깝다=adj.可惜
아끼다=v.節省
아나운서=n.廣播員
아내=n.妻子
아냐=不是
아뇨=表示否定
아니=adv.不
아니다=adj.不是
아니야=adv.不
아니요=int.沒有
아니하다=adj.表示否定
아드님=兒子
아들=n.兒子
아래=n.下麵
아래쪽=n.下面,下邊
아래층=n.樓下
아랫사람=n.晚輩
아르바이트=n.兼職打工
아름답다=adj.美麗
아마=adv.可能
아마도=adv.大概,可能,也許;n.胡麻
아무=pron.什麼
아무개=pron.某
아무것=什麼東西
아무래도=怎麼說也
아무런=任何
아무렇지않다=不亂
아무리=adv.多麼
아무튼=adv.好歹,不管怎麼樣
아버님=爸爸
아버지=n.爸爸
아빠=爸爸
아쉬움=遺憾
아쉽다=可惜
아스팔트=n.柏油路
아시아=n.亞洲,亞洲大陸
아아=哦,呀,唉,烏,嗐(尾語)
아예=adv.乾脆,索性
아울러=adv.同時
아유=噯,哎呀
아이=n.孩子
아이고=哎呀
아이디어=n.主意,想法
아이스크림=n.霜淇淋
아저씨=n.大叔
아주=adv.非常
아주머니=n.大媽
아줌마=阿姨
아직=adv.尚未
아침=n.早晨
아파트=n.小區,公寓
아프다=adj.疼
아프리카=n.非洲
아픔=n.疼痛
아하=int.啊哈,啊
아홉=num.9
아흔=num.九十
악기=n.樂器
악몽=n.惡夢
악수=n.傾盆大雨,滂沱大雨
안=adv.內
안개=n.霧
안경=n.眼鏡
안과=n.眼科
안기다=坐懷不亂
안내=n.帶路,引導,嚮導,介紹,指南,服務,查詢,陪同
안내하다=說明
안녕=再見
안녕하다=adj.平安,安好
안녕히=n.再見
안다=抱
안동=安東(地名)
안되다=v.行,不能,不成
안방=內房
안부=平安與否
안심하다=安心
안전=n.安全
안전하다=adj.安全
안정=n.穩定
안정되다=安定
안주=小菜
안쪽=內側
안타깝다=adj.遺憾的,可惜的
안팎=n.內外,裡外
앉다=v.坐
앉히다=v.任,…坐下
않다=v.不(做)
알=粒,蛋
알다=v.知道
알려지다=v.馳,傳播,傳開
알루미늄=n.鋁
알리다=不明白
알맞다=適合
알아내다=v.認出,打聽
알아듣다=v.聽懂
알아보다=v.了解,打聽,詢問
알아주다=v.了解,理解
알코올=n.酒精
앓다=患病
암=n.雌的,母的
암시=n.暗示
암컷=n.母的,雌的,牝的
압력=壓力
앞=n.前
앞길=前途
앞날=未來
앞두다=v.以前,前夕
앞뒤=n.前後,先後
앞문=n.前門,大門
앞바다=近海
앞서=先
앞서다=先行
앞세우다=領先
앞장서다=v.帶頭,領頭,站在前頭
앞쪽=n.前方
애=心機
애쓰다=費心
애인=戀人
애정=愛情
애초=當初
액세서리=飾品
액수=n.額數
앨범=n.相冊
야간=n.夜間,夜晚
야구=n.棒球
야구장=棒球場
야단=n.喧嚷,奔忙
야옹=adv.咪咪(貓叫聲)
야외=n.野外
야채=n.野菜
야하다=adj.粗野,不大方
약=n.藥
약간=adv.稍微
약국=n.藥店
약속=n.約定,約會
약속하다=約定
약수=藥水
약점=n.弱點
약품=n.藥品
약하다=弱
약해지다=弱勢
약혼녀=未婚妻
약혼자=未婚夫
얄밉다=奸邪
얇다=薄
양=n.羊
양국=n.兩國
양념=n.調料
양력=陽曆
양말=n.襪子
양배추=n.洋白菜,捲心菜,包心菜
양보=n.謙讓
양보하다=n.讓步
양복=n.西服
양상추=n.萵苣
양식=n.糧食
양심=n.良心
양옆=n.兩邊
양주=n.釀酒
양쪽=n.兩邊
양파=n.洋蔥
얕다=淺
얘=n.呀,唷(詞尾)
얘기=n.聊天,故事
얘기하다=述說
어=n.啊,咳,咍
어기다=v.違背
어깨=n.肩膀
어느=adv.哪個
어느덧=不知不覺之間
어느새=不知不覺之間
어두워지다=暗
어둠=暗
어둡다=adj.昏暗
어디=adv.哪兒
어때=怎麼樣?
어떠하다=adj.怎麼樣,什麼樣
어떡하다=怎麼辦
어떤=什麼
어떻다=怎樣
어려움=難
어려워지다=變困難了
어렵다=adj.困難
어른=n.大人
어리다=adj.年紀小,不成熟
어리석다=adj.愚蠢,愚笨
어린아이=n.小孩兒
어린애=小孩
어린이=n.小孩
어린이날=n.兒童節
어머=哎喲,我的媽
어머니=n.媽媽
어머님=媽媽
어색하다=adj.彆扭
어서=adv.快
어울리다=v.相稱
어저께=n.昨天
어제=n.昨天
어젯밤=昨夜,昨天晚上
어지럽다=adj.暈,昏
어째서=adv.為什麼,做什麼
어쨌든=怎麼說也
어쩌다=v.偶爾,有時
어쩌다가=adv.偶爾,有時
어쩌면=怎樣才…
어쩐지=不知為何…
어쩜=優美
어찌=怎麼能…
어찌나=adv.怎麼,怎能,哪能
어찌하다=v.怎麼搞,怎麼辦
억=億
억울하다=adj.冤枉的,委屈的
언니=n.姐姐(女性稱呼女性)
언덕=山丘
언론=n.言論
언어=n.語言
언제=adv.什麼時候
언제나=adv.總是,習慣性地(always)
언젠가=有朝一日
얹다=放
얻다=得到
얻어먹다=v.接受別人的請客
얼굴=n.臉
얼다=結冰
얼른=adv.迅速地,快速地
얼리다=v.絞住,凍,瞞
얼마=n.多少,若乾
얼마간=adv.多少,多多少少,或多或少
얼마나=adv.多
얼음=冰塊
얼핏=adv.瞥見,過眼
엄격하다=adj.嚴厲的,嚴格的
엄마=n.媽媽
엄숙하다=嚴肅
엄청나다=adj.極大,極多,格外,分外,特別
업다=背
업무=n.業務
업종=行業
업체=n.企業
없다=adj.沒有
없애다=取消
없어지다=消失
없이=adv.毫無,沒有
엇갈리다=v.錯過
엉덩이=n.屁股
엉뚱하다=adj.亂折騰,膽大妄為
엉망=n.亂糟糟
엉터리=n.荒誕,荒唐
엊그제=n.前天,前些日子
엎드리다=v.趴,伏,臥,臥倒
에너지=n.能量
에어컨=n.空調
엔=日元,Yen
엔진=n.引擎,發動機
엘리베이터=n.電梯
여=n.女
여가=n.餘暇,空閒
여간=adv.了不得地
여건=呂虔
여겨지다=算得,聽起來
여고생=女高中生
여관=旅館
여군=女兵
여권=n.護照
여기=pron.這裡
여기다=認為
여기저기=到處
여대생=女大學生
여덟=num.八
여동생=n.妹妹
여든=八十
여러=pron.各種
여러분=pron.各位
여럿=很多
여론=n.輿論
여름=n.夏天
여름철=夏季
여보=int.喂(平輩之間稱呼)
여보세요=int.喂-(打電話時用做"你好")
여섯=num.六
여성=女性
여왕=n.女王
여우=n.狐狸
여유=n.閒暇
여인=女人
여자=n.女子
여전하다=adj.如前,仍然,依然如故
여전히=adv.依然
여직원=女職員
여쭈다=v.告訴,稟告,進言(對長輩)
여학생=女學生
여행=n.旅行
여행사=旅行社
여행하다=v.旅行
역=站
역사=n.歷史
역사가=n.歷史學家
역사상=歷史上
역사적=歷史的
역사학=n.歷史學,史學
역시=又是
역할=n.作用
연간=年間
연결=n.連接
연결되다=連接,相連
연결하다=連接
연관=n.關聯,關係,聯繫
연구=n.研究
연구소=n.研究所
연구실=研究室
연구원=n.研究院
연구자=n.研究者
연구하다=研究
연극=n.話劇
연기=n.演技
연기되다=延期
연기자=n.表演者
연기하다=延期
연두색=n.淡綠,淺綠
연락=n.聯絡
연락처=n.聯絡處
연락하다=v.聯絡
연령=n.年齡
연말=n.年末
연상하다=聯想
연설=n.演說
연세=n.(敬)年齡
연속=n.adv.續
연습=n.練習
연습하다=v.練習
연애=n.戀愛
연예인=n.藝人
연인=n.戀人
연장=n.工具
연주=n.演奏
연출=n.導演
연출하다=演出
연필=n.鉛筆
연하다=adj.(顏色,濃度)淺或淡
연합=聯合
연휴=連休
열=n.熱,熱量
열기=n.熱氣
열다=v.打開
열리다=結果
열매=n.果實
열쇠=鑰匙
열심히=adv.認真地
열정=熱情
열중하다=熱衷,沉浸
열차=n.列車
열흘=十天
엷다=adj.薄
염려=n.擔心,掛念
염려하다=v.擔心
엽서=n.明信片
엿보다=v.偷看
영=adv.永遠
영국=n.英國
영남=嶺南
영상=n.零上
영양=營養
영어=n.英語
영업=n.營業,銷售
영역=n.領域
영웅=n.英雄
영원하다=永遠
영원히=永遠
영하=零下
영향=n.影響
영향력=n.影響力
영혼=靈魂
영화=n.電影
영화관=電影院
영화배우=n.電影演員
영화제=電影節
옆=n.旁邊
옆구리=n.肋下
옆방=隔壁
옆집=n.鄰居
예=int.是的
예감=n.預感
예고하다=預告
예금=n.訂金,預存款
예매하다=預售
예방=n.預防
예방하다=預防
예보=n.預報
예비=n.預備
예쁘다=adj.漂亮
예산=n.預算
예상=n.預想
예상되다=預料,意料
예상하다=預想
예선=n.預選
예순=num.六十
예술=n.藝術
예술가=n.藝術家
예술적=adj.藝術(的)
예습=n.預習
예습하다=預習
예식장=禮式場
예약=n.預約
예약하다=v.預約
예외=n.例外
예의=n.禮貌
예전=n.過去,從前
예절=禮儀
예정=n.預定
예정되다=計畫,打算
예측하다=預測
예컨대=adv.例如
옛=古老
옛날=n.很久以前
옛날이야기=昔日的故事
오=n.哦,喔,五
오가다=來往
오늘=n.今天
오늘날=今天
오다=v.來
오락=娛樂
오래=adv.久地
오래간만=n.好久
오래도록=好久好久
오래되다=久
오래전=很久以前
오랜=老
오랜만=n.隔很長時間
오랫동안=n.好久
오렌지=柳橙
오로지=只有
오르내리다=v.上上下下
오르다=v.(物價,指數等)上漲
오른발=右腳
오른손=右手
오른쪽=n.右邊
오리=n.鴨子
오븐=烤爐
오빠=n.哥哥(女稱男)
오십=n.五十
오염=n.污染
오염되다=被污染
오월=n.五月
오이=n.黃瓜
오전=n.上午
오직=只有
오징어=n.魷魚
오페라=n.歌劇
오피스텔=n.商住兩用房
오해=n.誤會
오후=n.下午
오히려=adv.反而
옥상=n.屋頂
옥수수=n.玉米
온=所有
온갖=int.各種,一切,所有的
온도=溫度
온돌=n.炕
온라인=網路,連線,上網
온몸=全身
온종일=n.整天,整日
온통=全部
올=n.線條兒,股,今年
올가을=n.今秋,今年秋天
올라가다=v.上去
올라서다=v.登上,達到
올라오다=v.上來,攀登
올라타다=騎
올려놓다=放上
올려다보다=抬頭看
올리다=提高價錢
올림픽=n.奧林匹克
올바르다=正確
올여름=今年夏天
올해=n.今年
옮기다=v.搬動
옳다=adj.正確
옷=n.衣服
옷차림=n.衣著,穿著,穿戴
와=n.和,同,與
와이셔츠=n.襯衫
와인=酒紅
완벽하다=完美
완성=n.成
완성되다=被完成
완성하다=完成
완전=完全
완전하다=adj.完整
완전히=adv.完全,充分
왕=n.王
왕비=n.王妃
왕자=n.王子
왜=adv.為什麼
왜냐하면=adv.之所以
왠지=不知為什麼
외=n.獨
외갓집=n.外婆家
외과=外科
외교=n.外交
외교관=外交官
외국=n.外國
외국어=外國語
외국인=n.外國人
외다=背
외로움=n.孤獨(名詞型)
외롭다=孤單
외면하다=v.回避
외모=n.外貌
외부=外部
외삼촌=舅舅
외아들=n.獨生子
외우다=背
외제=外國制
외출=n.外出
외출하다=外出
외치다=v.頭轉向一邊
외침=n.呐喊,叫喊
외할머니=n.外婆
외할아버지=n.外公
왼발=左腳
왼손=左手
왼쪽=n.左邊
요=這,哩,堯
요구=n.要求
요구되다=要求
요구하다=需要
요금=n.費用
요리=n.料理
요리사=n.廚師
요리하다=做菜
요새=n.要塞
요약하다=概括
요일=n.星期
요즈음=n.近來,這兩天
요즘=adv.最近
요청=n.要求,請求,邀請
요청하다=邀請
욕=罵人的話
욕실=n.浴室
욕심=n.欲望,貪欲
욕하다=罵人
용=龍
용감하다=勇敢
용기=勇氣;容器
용도=用途
용돈=n.零花錢
용서=n.寬恕,饒恕
용서하다=v.饒恕
용어=用語
우려=n.憂慮
우리=pron.我們
우리나라=我國,我們國家
우리말=韓語,Korean
우산=n.雨傘
우선=adv.首先,優先
우수하다=優秀
우습다=adj.可笑,滑稽
우승=n.取勝,冠軍
우승하다=得冠軍
우아하다=adj.優雅
우연히=adv.偶然地
우울하다=憂鬱
우유=n.牛奶
우정=n.友情
우주=n.宇宙
우체국=n.郵局
우편=n.郵政
우표=n.郵票
운=n.運氣
운동=n.運動
운동복=n.運動服
운동장=運動場
운동하다=v.運動
운동화=n.運動鞋
운명=命運
운반=n.搬運
운영하다=運營,管理
운전=n.駕駛
운전기사=司機
운전사=n.司機
운전자=n.開車的人
운전하다=v.駕駛
운행=n.運行
울다=哭
울리다=v.鳴響
울음=n.哭泣
울음소리=n.哭聲
움직이다=v.移動
움직임=行動
웃기다=逗笑
웃다=v.笑
웃어른=長輩
웃음=n.笑
웃음소리=n.笑聲
워낙=adv.本來,原來
원=希望;圓
원고=n.原稿
원래=adv.原來
원서=n.原件,申請表
원숭이=n.猴子
원인=n.原因
원장=n.院長
원피스=n.衣裙
원하다=v.指望,希望
월=n.月
월급=n.月薪
월드컵=世界盃
월세=n.按月付款
월요일=n.星期一
웨이터=n.侍者,服務員(飯店)
웬=pron.哪來的,幹什麼的
웬만하다=adv.差不多,一般
웬일=n.什麼事
위=n.上面
위기=n.危機
위대하다=adj.偉大
위로=n.慰勞
위로하다=v.慰勞
위반=n.違反
위반하다=危險
위법=n.違法
위성=n.衛星
위아래=n.上下,老少
위원=n.委員
위원장=n.委員長
위주=n.為主
위쪽=n.上頭,上面
위층=樓上
위치=n.位置
위치하다=位置
위하다=為了
위험=n.危險
위험성=危險
위험하다=adj.危險
위협=n.威脅
윗몸=n.上體
윗사람=n.長者
유교=儒教
유난히=adv.特別,格外
유능하다=adj.有能力
유럽=n.歐洲
유리=玻璃
유리창=n.玻璃窗
유리하다=adj.有利
유머=n.幽默
유명=adj.著名
유명하다=adj.著名的
유물=遺物
유발하다=v.誘發
유사하다=adj.類似的
유산=n.遺產
유월=n.六月
유의하다=注意
유적=n.遺址
유적지=n.遺址
유지되다=保持,維持
유지하다=v.維持
유치원=n.幼稚園
유학=n.留學
유학생=留學生
유행=n.流行
유행하다=流行
유형=n.類型
육=num.六
육군=n.陸軍
육상=田徑
육십=num.六十
육체=n.肉體,身體
육체적=n.肉體的,身體的
으레=adv.應當,當然,照例
으응=欸,嗯
은=n.銀
은은하다=adj.隆隆
은행=n.銀行
음=n.音
음력=n.陰歷
음료=n.飲料
음료수=n.飲料
음반=n.唱片
음성=n.聲音(說話),噪音
음식=n.食物
음식물=n.食物
음식점=餐館
음악=n.音樂
음악가=n.音樂家
음주=n.飲酒
응=n.是(非敬語)
응답하다=答應,回應
의견=n.意見
의논=n.議論
의논하다=議論
의도=n.意圖
의도적=有目的地,神秘化
의류=n.衣類,服裝類
의무=n.義務
의문=疑問
의미=n.含義,意味
의미하다=意味
의복=n.衣服
의사=n.醫生
의식=n.儀式,意識
의식하다=意識,儀式
의심=疑心
의심하다=疑心
의외로=n.意外
의욕=n.意欲,意志
의원=n.議員
의자=n.椅子
의존하다=依存,依賴
의지=n.意志
의지하다=靠
의하다=依據
의학=n.醫學
이=pron.這個,牙齒
이같이=上述
이거=pron.這
이것=pron.這個
이것저것=n.這個那個
이곳=這裡
이곳저곳=到處
이기다=勝利
이끌다=v.拉著
이날=以那
이내=以內
이념=n.理念
이놈=好小子
이다음=v.頂(東西)
이달=n.本月
이대로=adv.就此
이데올로기=n.意識形態
이동=n.移動
이동하다=移動
이따가=adv.過一會兒,以後
이따금=adv.偶爾
이때=這時,此時
이래=n.以來
이래서=n.以來
이러다=這樣做,這麼做
이러하다=adj.這樣,如此
이런=int.噯呀(感到意外時)
이런저런=pron.這樣那樣的
이렇게=adv.這樣
이렇다=這樣
이력서=n.履歷表
이론적=n.理論的,理論性的
이롭다=adj.有利
이루다=達成
이루어지다=v.形成,實現
이룩하다=v.實現,建成,蓋
이뤄지다=形成,實現,做成
이르다=早
이름=n.姓名
이리=n.這裡
이리저리=adv.這樣那樣
이마=額頭
이모=n.姨媽
이미=已經
이미지=n.圖片,印象
이민=n.移民
이발소=n.理髮店
이번=n.這次
이별=n.離別,別離,分手,分袂
이분=這位
이불=被子
이빨=n.牙齒
이사=n.搬家
이사장=n.董事長,社長
이사하다=v.搬家
이상=n.以上
이상적=n.理想的,合乎理想的
이상하다=adj.異常
이성=理性
이슬=n.露水
이십=num.二十
이야기=n.故事
이야기하다=v.說
이어=adv.接著
이어서=adv.接著
이어지다=v.連及,連接
이외=以外
이용=n.利用
이용되다=用
이용자=用戶
이용하다=v.活用
이웃=n.鄰居
이웃집=n.鄰居
이월=n.二月
이유=n.理由
이윽고=adv.一會兒
이익=利益
이자=n.利息
이전=n.以前
이제=adv.現在,馬上
이제야=n.現在,目前
이중=n.二重,雙重
이쪽=n.這邊
이튿날=第二天
이틀=n.兩天
이하=n.以下
이해=n.理解
이해관계=n.利害關係
이해되다=…理解,…了解
이해하다=v.理解
이혼=n.離婚
이혼하다=離婚
이후=n.以後
익다=v.熟,成熟
익숙하다=adj.熟練,熟悉
익숙해지다=得來,熟慣
익히다=v.通過學習掌握(操作和技術)
인=n.癮,仁,磷
인간=n.人
인간관계=n.人際關係
인간성=n.人性
인간적=adj.人的,人間的
인격=n.人格
인공=n.人工
인구=n.人口
인근=n.鄰近
인기=n.人氣
인도=n.人道
인류=n.人類
인물=人物
인분=n.[C]每份食品
인사=n.問候
인사말=n.問候語
인사하다=v.請安
인삼=n.人蔘
인삼차=n.人參茶
인상=n.印象,(物價,工資等)上升
인상적=n.印象深刻
인생=n.人生
인쇄=印刷
인식하다=v.認識到,悟到
인연=n.姻緣
인원=人員
인재=人才
인정되다=被承認
인정받다=獲得認可
인정하다=承認
인제=n.現在
인종=n.人種
인천=n.仁川(地名)
인천공항=仁川機場
인체=n.人體
인터넷=n.網際網路
인터뷰=n.面試
인하=n.降低(物價)
인하다=v.因為,由於
인형=n.洋娃娃,玩偶
일=n.事情
일곱=num.七
일기=n.日記
일단=n.一端,一頭兒
일대=n.地區
일등=n.一等,第一名
일반=一般
일반인=n.普通人
일반적=一般的
일본=n.日本
일본어=n.日本語
일부=一部份
일부러=adv.故意
일상=n.日常
일상생활=日常生活
일상적=日常,經常
일생=n.一生
일손=n.手
일시적=一時的
일식=n.日蝕
일쑤=n.經常做的行為
일어나다=v.起來
일어서다=v.站起來
일요일=n.星期日
일월=n.一月,正月
일으키다=起來
일일이=adv.事事
일자=n.日子
일자리=n.工作,崗位
일정=n.日程
일정하다=一定
일종=n.一種
일주일=n.一周
일찍=adv.早地
일찍이=adv.曾經,久已
일체=一切
일치=n.一致
일치하다=adj.一致的
일하다=v.做事
일행=n.一道走
일회용=n.一次性
일회용품=n.一次性用品
일흔=n.七十
읽다=v.閱讀(書或報紙等)
읽히다=v.被讀,使某人讀
잃다=v.丟失
잃어버리다=v.丟失
임금=n.工錢,群主(王)
임무=任務
임시=n.臨時
임신=n.妊娠
임신부=n.孕婦
임신하다=懷孕,妊娠
입=n.口,嘴
입구=入口
입국=n.進入國境,入境
입다=v.穿
입대=n.入隊,入伍
입력=n.(電腦上的)輸入
입력하다=輸入
입맛=n.胃口
입사=n.投射
입사하다=加入公司
입술=嘴唇
입시=n.口,嘴
입원=n.住院
입원하다=住院
입장=n.立場
입학=入學
입학하다=考入學校
입히다=包
잇다=連接
잇따르다=v.接踵
있다=adj.在
잊다=v.忘記
잊어버리다=v.忘記,遺忘
잊혀지다=被遺忘
잎=葉子
자=n.尺
자가용=私用
자격=n.資格
자격증=n.資格證書
자극=n.刺激
자극하다=刺激
자기=n.自己
자꾸=adv.反覆地,總是
자꾸만=adv.老是,總是
자네=pron.你(第二人稱代詞)
자녀=n.子女
자다=v.睡覺
자동=n.自動
자동차=n.汽車
자라나다=長大
자라다=成長
자랑=n.驕傲的事情
자랑스럽다=adj.值得驕傲的
자랑하다=v.誇耀
자료=n.資料
자르다=v.切斷
자리=n.座位,位置
자매=n.姊妹
자부심=n.豪感,自信心
자살=n.自殺
자살하다=自殺
자세=n.姿勢
자세하다=adj.仔細
자세히=仔細地
자식=自己
자신=n.自己
자신감=n.自信感
자연=n.自然
자연스럽다=自然
자연적=n.然的
자연현상=自然現象
자연환경=自然環境
자연히=自然地
자원=資源
자유=n.自由
자유롭다=自由的
자율=n.自律
자장면=炸醬麵
자전거=n.自行車
자정=n.子夜
자존심=自尊心
자주=adv.經常
자체=n.本身
자취=n.蹤跡,痕跡
자판=鍵盤
자판기=n.自動販賣機
작가=n.作家
작년=n.去年
작다=adj.小
작성=n.制訂,擬訂(事件,報告)等
작성하다=組成
작아지다=人貧志短
작업=n.勞動,工作
작용=作用
작용하다=作用
작은딸=n.小女兒
작은아들=小兒子
작은아버지=叔叔
작은어머니=嬸母
작품=n.作品
잔=n.[C]玻璃
잔디=n.短草,矮草
잔디밭=n.草坪
잔뜩=滿滿地
잔치=n.酒席,宴會
잘=adv.好好地
잘나다=adj.長得俊,長得好看,好看
잘되다=v.好
잘리다=v.被…切斷
잘못=n.過錯,錯誤
잘못되다=錯
잘못하다=做錯
잘살다=過得好
잘생기다=adj.長得好看,長得漂亮
잘하다=v.做得好
잠=n.覺(sleep)
잠그다=v.泡浸
잠기다=v.鎖,閉,扣上
잠깐=adv.稍微
잠들다=v.入睡
잠바=n.夾克
잠수함=n.潛水艇
잠시=adv.暫時
잠옷=n.睡衣
잠자다=睡覺
잠자리=n.睡床,睡覺的地方
잡다=v.捉住
잡수다=v.吃(敬語)
잡수시다=v.吃
잡아당기다=v.拉,扯
잡아먹다=v.抓吃,糾纏
잡지=n.雜誌
잡히다=被抓住
장=n.[C]紙
장가=n.娶妻(男子結婚)
장갑=n.手套
장관=n.壯觀
장군=n.將軍
장기간=長時間
장기적=n.長期的
장난=n.玩耍
장난감=玩具
장남=n.長男
장래=n.餅來
장례=n.葬禮
장례식=n.葬禮
장르=n.體裁
장마=n.雨季
장면=場面
장모=n.丈母娘,岳母
장모님=n.丈母娘,岳母
장미=n.玫瑰
장비=n.喪葬費
장사=n.生意
장사꾼=n.商販,商人
장소=n.場所
장수=n.長壽
장식=n.掩飾
장애인=n.殘疾人
장인=n.匠人
장점=n.長處,優點
장차=adv.將來
장학금=n.獎學金
잦다=v.滲透(水)
재능=才能
재다=v.量,測量
재료=n.資料,材料
재미=有趣
재미없다=沒趣
재미있다=adj.有趣,有意思
재밌다=有趣
재빨리=adv.敏捷地,迅速地
재산=n.財產
재생=n.重生,再生,復活
재수=n.運氣
재우다=v.醃製,使睡覺
재작년=n.前年
재정=財政
재주=才藝
재즈=n.爵士樂
재채기=噴嚏
재판=n.再版,審判,審理
재학=n.在校
재활용=n.再利用,迴圈利用
재활용품=n.可回收物品
쟤=他
저=pron.鄙人
저거=pron.那個
저것=pron.那個
저고리=n.上衣
저곳=那邊
저기=pron.那
저녁=n.晚上
저녁때=晚上
저러다=v.那樣做
저런=int.唉呀(驚疑)
저렇게=adv.那個,那麼
저렇다=adj.那麼,那個
저리=那裡
저마다=各自
저번=n.那回,上一次
저울=n.秤
저자=n.作者
저절로=adv.自行
저지르다=v.弄壞,搞壞,搞糟
저쪽=那邊
저축=n.儲蓄
저편=那邊
저희=pron.我們
적=敵人
적극=n.積極
적극적=n.積極
적다=adj.少
적당하다=適當的
적당히=adv.適當地
적성=n.赤誠,忠誠
적어도=至少
적어지다=v.減少
적용=v.適用,應用
적용되다=被適用
적용하다=適用,應用
적응=n.適應
적응하다=適應
적절하다=adj.恰當
적합하다=adj.適合,合適
적히다=v.寫著,記著
전=adj.全部
전개=n.開展
전개되다=v.開展
전개하다=開展
전공=n.(大學)專業
전공하다=專攻
전구=n.電燈泡
전국=n.全國
전국적=全國的
전기=n.電
전기밥솥=電子鍋
전날=n.前一方
전달=n.傳達,傳話
전달되다=傳達,傳告
전달하다=傳達
전라도=n.邊緣
전망=n.前景
전망하다=展望,前景,前瞻
전문=專門
전문가=n.專家
전문적=n.專門的
전문점=專門店
전문직=專業性職業
전반=整個
전반적=全般的
전부=全部
전선=電線
전설=n.傳說
전세=n.傳貰
전시=n.展覽,展示
전시되다=展示
전시장=展示場
전시하다=v.展示
전시회=n.展覽會
전용=n.專用
전자=n.電子
전쟁=n.戰爭
전철=n.轍
전체=全體
전체적=n.全體的,整體的
전통=n.傳統
전통문화=n.傳統文化
전통적=n.傳統的
전하다=v.傳
전해지다=流傳
전혀=adv.全然
전화=n.電話
전화기=n.電話機
전화번호=n.電話號碼
전화하다=v.電話
전환=n.轉換,變換
전환하다=轉換,轉變
전후=n.前後
절=n.寺廟
절대=絕對
절대로=adv.絕對
절대적=絕對
절망=絕離
절반=一半
절약=n.節約
절약하다=節約
절차=n.程式
젊다=年輕
젊은이=n.年輕人
젊음=年輕
점=n.點,占卜
점검=n.檢查
점수=分數
점심=n.中午
점심때=n.中午時分
점심시간=n.午飯時間
점원=n.店員
점잖다=adj.端莊,斯文,持重
점점=adv.漸漸地
점차=漸漸
접근=n.接近
접근하다=接近,靠近
접다=n.折,折疊
접시=n.碟子,盤子
접촉=n.接觸
접하다=v.朝,向,經歷,接到
젓가락=n.筷子
젓다=搖;攪
정=n.鑿子
정거장=車站
정기=n.定期
정기적=n.定期的
정답=n.正確答案
정당=n.政黨
정도=程度
정류장=車站
정리=n.安排
정리되다=整治,整頓
정리하다=整理
정말=adv.真是
정말로=n.真話,真的
정면=正面
정문=正門
정반대=n.完全相反
정보=n.資訊,情報
정보화=信息化
정부=n.政府
정비=n.正比
정상=n.頂峰
정상적=n.正常的
정성=n.精心
정식=n.正餐
정신=n.精神
정신과=n.精神
정신없이=昏了頭腦
정신적=n.精神的
정오=n.正午
정원=n.庭院
정장=正式勳章,正裝
정지=停止
정직하다=adj.正直的
정치=n.政治
정치권=政壇
정치인=n.政客
정치적=n.政治的,政治性的
정치학=n.政治學
정하다=v.選定
정해지다=定了
정확하다=正確
정확히=正確地
젖=n.奶,乳
젖다=濕
제거하다=根絕
제공=n.提供
제공하다=v.提供
제과점=蛋糕店
제대로=adv.順利地,正常地
제대하다=退伍,解甲
제도적=制度
제목=題目
제발=千萬
제법=adv.像樣
제비=n.燕子
제사=n.題詞
제삿날=n.祭日
제시=v.出示,提出,提示
제시되다=提供,提出
제시하다=提示
제안=n.提案
제안하다=提議,提案
제약=n.製藥
제외되다=被排除
제외하다=除外
제의=n.提議,建議
제의하다=提議
제일=adv.最…,第一
제자=n.弟子,學生
제자리=n.原位,原地
제작=製造
제작하다=製作
제주도=n.濟州島
제출=n.提出
제출하다=提出
제품=商品
제한=限制
제한되다=受限制
제한하다=v.制約
조=n.兆,1兆
조각=n.片,塊
조개=n.貝,蚌
조건=n.條件
조그마하다=adj.小
조그맣다=adj.半點,小
조금=adv.一點點,稍微
조금씩=一點點地
조기=n.黃花魚,石首魚
조깅=n.慢跑
조르다=v.捆緊,勒緊,殺緊
조명=n.照明
조미료=調味料
조사=n.調查
조사하다=調查
조상=n.祖先
조선=n.朝鮮
조심스럽다=小心
조심하다=v.當心
조용하다=adj.安靜
조용히=adv.安靜地
조절=n.調整,調節
조절하다=調節
조정=n.調停
조정하다=調整
조직=n.組織
조카=n.侄子
조화되다=調和,協調
존경하다=尊敬
존댓말=n.敬語,謙語
존재=n.存在
존재하다=存在
존중하다=尊重
졸다=v.打瞌睡
졸리다=v.發困
졸업=n.畢業
졸업생=n.畢業生
졸업하다=畢業
졸음=n.睏意,睡意
좀=adv.稍微
좁다=adj.窄
좁히다=縮小
종=鐘
종교=n.宗教
종교적=宗教
종로=n.鍾路
종류=種類
종소리=n.鐘聲
종업원=從業員
종이=n.紙
종이컵=n.紙杯
종일=n.一整天
종종=adv.有時候,偶爾
종합=綜合
종합하다=綜合
좋다=adj.好
좋아=真好
좋아지다=v.變好,好轉
좋아하다=v.喜歡
좌석=n.座位
좌우=n.左右
죄=n.罪
죄송하다=adj.對不起
죄인=n.罪人,罪犯
주=n.周,一周
주거=朱據
주고받다=phr.交往,往來
주관적=主觀的
주년=n.周年
주다=v.給予
주로=adv.主要
주름=n.皺折,皺紋
주름살=皺紋
주말=n.週末
주머니=n.口袋
주먹=拳頭
주무시다=v.就寢,是자다的敬語
주문=n.訂閱,預訂
주문하다=v.訂閱,點菜
주민=住民
주방=n.廚房
주변=n.周邊
주부=n.主婦
주사=注射
주소=n.地址
주스=n.果汁
주식=n.股票,主食
주어지다=造成
주요=主要
주요하다=重要
주위=n.周圍
주의=n.主義
주의하다=注意
주인=n.主人
주인공=主人公
주일=週日
주장=n.主張
주장하다=主張
주저앉다=v.一屁股坐到地上
주전자=n.壺
주제=主題
주차=n.停車
주차장=停車場
주차하다=停車
주택=住宅
주한=駐韓
죽=n.粥
죽다=v.死亡
죽음=死
죽이다=殺
준비=n.準備
준비되다=準備好
준비물=準備好的東西
준비하다=v.準備
줄=隊,繩子
줄거리=n.情節
줄곧=一直
줄기=莖
줄다=v.減少
줄무늬=n.線紋
줄어들다=減少
줄이다=減少
줍다=撿
중=n.和尚
중간=中途
중계방송=n.轉播
중국=n.中國
중국어=中國話
중국집=n.中國餐廳
중년=n.中年
중단=n.中斷
중단되다=被中斷
중단하다=中斷
중대하다=重要
중독=n.中毒
중반=中期
중부=中部
중세=n.中世紀
중소기업=n.中小企業
중순=中旬
중식=n.午餐,中飯
중심=中心
중심지=中心
중앙=中心
중얼거리다=v.言自語,喃喃自語
중요=n.重要
중요성=n.重要性
중요시하다=重視
중요하다=adj.重要
중학교=中學
중학생=中學生
쥐=老鼠
쥐다=抓住
즉=也就是
즉석=n.即席,當場
즉시=n.adv.即時,立刻,立時
즐거움=n.快樂
즐거워하다=高興
즐겁다=adj.愉快
즐기다=v.享樂,享受
증가=n.增加
증가하다=增加
증거=証據
증권=n.證券
증권사=證券公司
증명하다=證明
증상=症狀
증세=n.症狀
지=n.以後,之後
지각=n.遲到
지갑=n.錢包
지겹다=adj.厭煩
지경=境地
지구=地球
지극히=adv.極為,非常,極端
지금=adv.現在
지금껏=adv.到現在為止
지급=n.支付,發給
지급하다=v.支出,付出
지나가다=經過
지나다=v.走過,經歷
지나치다=v.閃過
지난날=過去
지난달=上個月
지난번=n.上一次
지난주=n.上星期
지난해=n.去年
지내다=v.過
지능=n.智能,智商
지니다=v.攜帶
지다=輸
지대=地區
지도=n.地圖
지도자=n.領導人
지도하다=指導
지루하다=adj.沉悶的,乏味的
지르다=叫
지름길=n.捷徑
지리산=智異山
지방=n.脂肪
지배하다=v.支配
지불하다=v.支付
지붕=n.屋頂
지속되다=持續
지속적=持續
지시=n.指示
지시하다=指示
지식=知識
지식인=n.知識份子
지역=n.地域
지우개=n.擦子,橡皮
지우다=v.抹,擦
지워지다=消掉了
지원=n.支持,拹助
지원하다=支援
지위=n.地位
지저분하다=adj.亂七八糟,雜亂
지적=n.指出
지적되다=指出,提出
지적하다=v.指出
지점=n.分店
지지=n.支持
지진=n.地震
지출=n.支出
지치다=adj.累,疲勞
지켜보다=看
지키다=v.守護
지폐=n.紙幣
지하=地下
지하도=地下道
지하철=n.地鐵
지혜=n.智慧
직선=n.直線
직업=n.職業
직원=職員
직장=n.職場
직장인=n.上班族
직전=n.就要…的時候,即將…之前,前夕
직접=adv.直接
직접적=n.直接的
직후=n.剛…以後
진급=n.升級,升班
진단=診斷
진단하다=v.診斷
진달래=杜鵑
진동=n.振動
진로=前途
진료=n.診療
진리=真理
진실=真實
진실로=n.真實,誠實
진실하다=真實
진심=n.真心
진지하다=adj.真摯,真誠
진짜=n.真的;adv.真正地
진찰=n.診察
진출=n.登上,活動,活躍
진출하다=進入,准入
진통=n.陣痛
진하다=adj.(顏色)深
진행=n.進行
진행되다=行進,前進
진행자=主持人
진행하다=進行
질=質量
질문=n.提問,質問
질문하다=v.問
질병=n.疾病
질서=秩序
질적=n.質的,品質的
짐=n.行李
짐작=n.斟酌,估計
짐작하다=v.估計,預計
집=n.家
집다=拾
집단=集團
집단적=n.集體的
집안=n.家中,家內,家裡
집안일=n.家務事
집어넣다=v.放進,投
집중=n.集中
집중되다=集中
집중적=adj.集中的
집중하다=集中
짓=行動
짓다=v.做飯
짙다=濃
짚다=v.拄
짜다=adj.鹹
짜증=n.牢騷,不高興
짜증스럽다=adj.膩煩,氣人
짝=n.伴,雙,對
짧다=adj.短
짧아지다=v.變短
쩔쩔매다=v.團團轉
쪽=n.碎片兒
쫓겨나다=v.被趕走
쫓기다=v.被追趕
쫓다=v.驅逐,趕走
쭉=adv.一直
찌개=n.煎,炒
찌꺼기=n.渣滓
찌다=發(胖)
찌르다=刺
찍다=v.拍(照),(用刀或斧頭)砍
찍히다=v.被劈,被砍
찢다=v.撕,撕破
찢어지다=v.撕,撕破
차=n.車,茶
차갑다=冷
차남=n.次子
차다=adj.涼
차라리=adv.寧可,寧願
차량=n.車輛
차례=祭祀
차리다=準備
차림=n.穿戴,裝束
차마=adv.忍心
차별=n.差別
차선=n.車道線,次的
차이=n.差距
차이점=n.差異
차차=漸漸
차창=車窗
차츰=adv.慢慢
착각=n.錯覺
착각하다=v.誤認為
착하다=adj.善良的
찬물=n.涼水
찬성=n.贊成
찬성하다=贊成
참=adv.真是地
참가=n.參加
참가하다=v.蔘加
참고하다=參考
참기름=香油
참다=v.忍受
참되다=adj.真正
참새=麻雀
참석=n.出席,參加
참석자=n.出席者,參加者
참석하다=v.出席
참여=n.參與,參加
참여하다=v.蔘與
참외=n.甜瓜
참으로=adv.真的,的確
참조=n.參照
찻잔=茶杯
창=n.窗,唱,槍
창가=n.窗口
창고=食庫
창구=n.窗口
창문=n.窗戶
창밖=n.窗外
창작=創作
창조=n.創造
창조적=n.創造的,創造性的
창조하다=創造
창피하다=丟臉
찾다=v.尋找
찾아가다=v.走訪
찾아내다=找到
찾아다니다=尋找
찾아보다=查
찾아오다=來訪
채=n.著,和
채널=頻道
채소=n.蔬菜
채우다=充滿
채점=n.打分數,判卷
책=n.書
책가방=書包
책방=書店
책상=n.書桌
책임=n.責任
책임감=n.責任感
책임자=n.負責人
책임지다=負責
챔피언=n.冠軍
챙기다=v.整理,收拾
처녀=處女
처리=n.處理
처벌=n.處罰
처음=adv.初次,第一次
처지=n.處境,境地
척=n.尺
척하다=表示假裝
천=num.千(數量詞)
천국=n.天國,也就是天堂
천둥=n.雷霆,指雷電交加的天文現象
천장=n.天棚
천재=n.天才
천천히=adv.慢慢地
철=季節
철도=n.鐵道,鐵路
철저하다=adj.徹底的
철저히=adv.徹底地
철학=n.哲學
철학자=哲學家
철학적=n.哲學的
첫=第一次
첫날=n.第一天
첫째=n.第一
청년=n.青年,子弟
청바지=牛仔褲
청소=n.打掃
청소기=n.清潔器,吸塵器
청소년=n.青少年
청소하다=v.打掃
청춘=n.青春
청하다=要求
체계적=n.系統的
체력=體力
체온=n.體溫
체육=體育
체육관=體育館
체조=n.體操
체중=n.體重
체하다=積食,滯食
체험=n.體驗
체험하다=體驗
쳐다보다=抬頭看
초=初
초기=n.初期
초대=n.招待
초등학교=小學
초등학생=小學生
초록색=n.綠,草綠
초반=初期階段
초밥=壽司
초보=初步,初級
초보자=初學者
초상화=n.肖像畫
초순=n.初旬,上旬
초여름=n.初夏
초원=草原
초저녁=n.傍晚,黃昏
초점=n.焦點
초조하다=adj.焦躁
초청=n.邀請
초청장=n.聘書
초청하다=邀請
초콜릿=n.巧克力
촌스럽다=adj.土裡土氣
촛불=n.燭火
총=n.槍
총각=小夥子
총리=n.總理
총장=n.總長
촬영=n.攝影
최고=n.最高
최고급=n.特級,頭號
최근=最近
최대=n.最大
최대한=最大限度
최상=最好
최선=最佳
최소=n.最小
최소한=最小限度
최신=n.最新
최악=最壞
최저=n.最低
최종=最終
최초=最初
최후=n.最後
추가=n.追加,附加
추가되다=追加,添加
추가하다=追加
추다=跳舞
추석=n.秋夕,即中秋節
추억=n.回憶
추위=冷
추진=n.推進
추진하다=推進
추천=n.推薦,介紹
추천하다=v.推薦
추측=n.推測
축구=n.足球
축구공=n.足球
축구장=n.足球場
축소=n.縮小
축제=n.慶祝儀式
축하=n.祝賀
축하하다=祝賀
출구=出口
출국=n.出國
출근=n.上班
출근하다=v.上班
출발=n.出發
출발점=n.出發點
출발하다=v.出發
출산=分娩
출석하다=出席
출신=n.出身
출연=n.演出
출연하다=v.表演
출입=n.出入
출입국=出入境
출입문=n.出入的門
출장=n.出差
출퇴근=n.上下班
출판=n.出版
출판사=n.出版社
출현하다=出現
춤=n.舞蹈
춤추다=跳舞
춥다=adj.冷
충격=n.衝擊
충격적=令人震驚
충고=n.忠告
충돌=n.衝突
충돌하다=衝突
충분하다=忠告
충분히=adv.充分地
취미=n.興趣
취소=n.取消
취소하다=v.取消
취업=就職
취재=n.取材
취직=n.就業
취하다=取得
취향=n.志趣,情趣
층=n.層
치과=n.牙科
치다=打
치료=n.治療
치료법=v.治療法
치료하다=治療,治癒
치르다=v.支付
치마=n.裙子
치아=n.牙齒
치약=n.牙膏
치우다=v.整理
치즈=n.乾酪,乳酪
친구=n.朋友
친절=親切
친절하다=adj.和藹的,親切的
친정=n.娘家
친척=n.親戚
친하다=adj.親密的
친해지다=親近,釋懷
칠=num.七
칠십=num.七十
칠월=n.七月
칠판=n.黑板
칠하다=v.漆
침=n.唾沫,唾液,口水
침대=n.床
침묵=n.沈默
침실=寢室
침착하다=adj.沈著
칫솔=n.牙刷
칭찬=n.稱讚,讚揚
칭찬하다=稱讚
카드=n.卡片
카레=咖哩
카메라=n.照相機,攝影機
카운터=櫃台
카페=n.咖啡館
칸=n.格,間
칼=n.刀子
칼국수=n.刀銷麵
캄캄하다=adj.漆黑
캐나다=n.加拿大
캐릭터=n.角色
캠퍼스=校園
캠페인=n.比賽,戰役
커다랗다=大
커지다=v.長大
커튼=n.窗簾,簾布
커피=n.咖啡
컨디션=n.身體的健康狀況
컬러=彩色
컴퓨터=n.電腦
컵=n.杯子
케첩=番茄醬
켜다=v.開,啟動
켜지다=v.著
코=n.鼻子
코끝=n.鼻尖
코끼리=大象
코너=n.角落
코드=n.軟線,電纜
코미디=n.戲劇
코스=n.路線
코스모스=n.大波斯菊(植)
코치=n.教練
코트=n.外套
코피=n.鼻血
콘서트=n.音樂會
콜라=n.可樂
콤플렉스=情結
콩=n.黃豆
콩나물=豆芽菜
쾌감=n.快感
크기=大小
크다=adj.大
크리스마스=n.耶誕節
크림=n.奶油
큰길=n.大路,公路,馬路
큰딸=n.大女兒
큰소리=n.大聲說話
큰아들=n.大兒子
큰아버지=n.伯父
큰어머니=n.伯母
큰일=大事
큰절=禮
클래식=假如愛有天意
클럽=n.俱樂部
키=n.身高,鑰匙
키스=n.接吻,親嘴
키우다=培養
킬로=n.千卡(路里),大卡
킬로그램=n.公斤
킬로미터=公里
타고나다=v.天生
타다=v.乘坐(交通工具)
타락=n.墜落
타오르다=v.燃燒
타입=n.澆灌
타자기=n.打字機
탁=adv.啪,啪嗒,突然
탁구=n.乒乓球
탁월하다=adj.卓越的
탁자=n.桌子
탄생=n.誕生
탄생하다=誕生
탈출하다=逃脫
탑=n.塔
탓=n.原因(反面現象)
태도=n.態度
태아=n.胎兒
태양=n.太陽
태어나다=v.出生
태우다=坐
태풍=n.颱風
택시=n.計程車
택하다=v.選擇,挑選
탤런트=n.影視明星,大腕
터=n.地基
터널=n.隧道,隧洞
터뜨리다=打破
터미널=n.始發站
터지다=v.裂
턱=下巴
털=n.毛
털다=v.抖摟
텅=adv.呯
테니스=n.網球
테러=n.恐怖
테스트=n.測試
테이블=n.桌子
테이프=n.帶子,彩帶
텍스트=n.原典,原文
텔레비전=電視
토끼=免子
토대=根基
토론=討論
토론자=n.發言者
토론하다=討論
토론회=n.討論會
토마토=蕃茄
토요일=n.星期六
토하다=吐
톤=噸
통=n.根本,完全地,只能用於口語
통계=n.統計
통과=n.通過
통과하다=通過
통로=n.通路
통신=n.通信
통역=n.翻譯(指口譯)
통일=n.統一
통일하다=統一
통장=n.存摺
통제=n.控制,統一管理,統制
통증=n.疼痛
통하다=通
통합=n.合併
통화=通話
퇴근=n.下班
퇴근하다=下班
퇴원=n.出院
퇴원하다=出院
퇴직금=n.退職金,一次付清的退休金
투명하다=adj.透明的
투자=n.投資
투표=n.投票
튀기다=v.彈
튀김=n.油炸食物
튀다=v.裂開,折斷(竹,木)
튀어나오다=v.突出,努
트럭=n.卡車
트이다=n.開豁,開擴
특급=n.特級
특별=n.特別
특별하다=特別
특별히=adv.特別地
특성=n.特性
특수=特殊
특수성=n.特殊性
특이하다=adj.特異,特殊
특정하다=特定
특징=特徵
특히=adv.特別,尤其
튼튼하다=adj.結實
튼튼히=adv.結實地,牢固地
틀=n.模型,框
틀다=扭
틀리다=v.錯誤
틀림없다=adj.沒錯,肯定的
틀림없이=adv.准,必,想必
틈=n.縫隙
티브이=電視,TV
티셔츠=n.T恤
팀=n.團隊
파=蔥
파괴하다=破壞
파다=挖
파도=n.海浪
파란색=n.藍色
파랗다=adj.藍的
파리=n.巴黎
파악하다=v.掌握,領會
파일=n.文件
파출소=n.辦事處
파티=n.聚會
판=n.局面,場面
판결=n.判決
판단=n.判斷
판단하다=判斷
판매=n.銷售
판매되다=銷售
판매하다=出售
판사=n.審判員
팔=n.胳膊,八(數字)
팔다=v.賣
팔리다=傾注
팔십=num.八十
팔월=八月
팝송=n.大眾歌曲
패션=n.潮流,時尚
팩=adv.哢嚓,猛然
팩스=n.傳真機
팩시밀리=傳真
팬=迷
팬티=n.小衣,女用內褲
퍼센트=n.百分比
퍼지다=v.伸展
퍽=相當
페인트=n.顏色,顏料
펴내다=出版
펴다=弄桌子
편=n.糕餅
편견=n.偏見
편리하다=adj.方便
편안하다=adj.舒服
편의=n.方便
편의점=n.便利店,便利商店
편지=n.信件
편하다=adj.舒服
편히=舒服
펼쳐지다=張開,展現
평=n.評,評論
평가=n.評價
평가되다=評價
평가하다=評價
평균=平均
평범하다=adj.平凡的
평상시=平時
평생=n.一生
평소=n.平時
평양=平壤
평일=n.平日
평화=和平
평화롭다=adj.和平
폐지=n.廢止
포근하다=adj.柔軟
포기하다=拋棄
포도=n.葡萄
포도주=n.葡萄酒
포스터=n.宣傳畫,招貼畫
포인트=n.效果
포장=n.包裝
포장마차=路邊攤
포크=n.叉子,餐叉
포함=n.包含
포함되다=包含
포함하다=包含
폭=n.寬度
폭넓다=adj.廣泛,全面
폭력=n.暴力
표=n.票,各種票據
표면=表面
표시=n.表示
표시하다=批示,明碼標價
표정=表情
표준=標準
표현=n.表現
표현되다=表現
표현하다=表現
푸다=v.舀,盛
푸르다=綠
푹=adv.充分地
풀=n.草
풀다=v.解開
풀리다=解決
풀어지다=v.解開,消除
품=n.胸圍
품다=懷
품목=n.貨物
품질=n.品質
풍경=n.風景,景致
풍부하다=豐富
풍속=n.風俗
풍습=n.風俗
프랑스=n.法國
프로=專業
프로그램=n.電腦程式
프린터=印表機
플라스틱=n.塑膠
피=血
피곤=n.疲勞,疲倦
피곤하다=adj.疲憊,疲勞,疲乏
피다=v.盛開
피디=報紙文章
피로=n.疲勞
피로하다=疲勞
피망=青椒
피부=n.皮膚
피시=n.PC,個人電腦
피우다=抽(煙)
피자=n.匹薩
피하다=v.躲避
피해=n.被害
피해자=n.被害者
필름=膠卷
필수=n.必要,必須
필수적=n.必須的,必要的
필연적=必然的
필요=n.必要
필요성=n.必要性
필요하다=adj.必要的
필자=n.筆者
필통=n.筆筒,筆盒
핑계=n.藉口
하=adv.太,好,哈
하긴=adv.說真的
하나=一個
하나님=num.一
하나하나=adv.一個一個,一件一件
하느님=n.上帝,老天爺
하늘=n.天空
하다=v.做
하도=adv.太
하드웨어=n.硬體
하루=n.一天
하룻밤=n.一夜
하반기=n.下半期
하숙집=n.租房(租賃的房子)
하순=n.下旬
하얀색=白色的
하얗다=雪白
하여튼=反正
하지만=conj.可是
하천=n.河川
하품=n.哈欠
하필=adv.何必
학과=n.專業
학교=n.學校
학교생활=校園生活
학급=學級
학기=學期
학년=學年
학력=n.學力
학번=學號
학부모=家長
학비=n.學費
학생=n.學生
학생증=學生證
학술=學術
학습=n.學習
학용품=n.學習用品
학원=n.補習班
학위=n.學位
학자=學者
학점=學分
한=num.一;大概
한가운데=n.正中,中間,當中
한가하다=adj.悠閒
한강=漢江(韓國)
한겨울=n.嚴冬
한결=adv.更加
한계=n.界限
한구석=n.角落
한국=n.韓國
한국말=n.韓國話
한국어=n.韓語
한국적=n.韓國,Korean
한글=韓國字
한글날=n.韓文節
한꺼번에=一下
한낮=n.正午
한눈=n.一眼,一看
한데=n.一個地方,一起
한동안=一時
한두=num.一兩個
한둘=num.一二
한때=一時
한라산=n.韓拿山(也叫漢孥山),在濟州島中部
한마디=一句
한문=漢文
한반도=n.韓半島
한밤중=n.深夜
한번=一次
한복=n.韓服
한순간=n.一轉眼,一展眼,刹那之間
한숨=一口氣
한식=韓國料理
한여름=n.仲夏,盛夏
한자=n.漢字
한잔=n.一杯
한잔하다=v.喝酒
한정되다=有限
한정하다=限定
한쪽=一邊
한참=n.較長的時間(一般指幾十分鐘)
한창=n.正是,正式時候
한층=adv.進一步,更加
한편=n.一邊
한평생=平生
한하다=v.限制
할머니=n.奶奶
할아버지=n.爺爺
할인=n.折扣
함께=adv.一起
함께하다=v.共,一起做,同事
함부로=adv.妄自,膽大妄為地
합격=n.合格
합격하다=合格
합리적=n.理的
합치다=調和
합하다=v.,合併
항공=航空
항공기=n.飛行器
항구=n.港口
항상=adv.向來,常常
항의=n.抗議
해=年
해결=n.解決
해결되다=被解決
해결하다=解決
해군=n.海軍
해내다=v.擔當,搞出來
해답=n.解答
해당=n.有關
해당되다=相當於
해당하다=相當
해롭다=adj.有害
해마다=每年
해물=海鮮
해석=n.解釋
해석하다=解釋
해설=n.解說
해소=n.咳嗽
해소하다=v.消除
해수욕장=海水浴場
해안=n.海岸,海邊
해외=海外
해외여행=出國旅行
핵=核
핵심=n.核心
핸드백=n.手提包
핸드폰=手機
햄=n.火腿
햄버거=n.漢堡
햇볕=n.陽光
햇빛=日光
햇살=日光
행동=n.行為,行動
행동하다=行動
행복=n.幸福
행복하다=adj.幸福的
행사=n.活動,一般指公開的活動
행운=n.幸運
행위=行為
행하다=v.行
향=n.香
향기=n.香氣
향상=n.提高
향상되다=提高
향수=香水
향하다=向
허가=許可
허락=n.許可,允許,答應
허락하다=允許
허리=n.腰
허용=n.容許
허용되다=允許,容許
허용하다=允許
허허=呵呵
헌=舊,爛,破
헤매다=v.徘徊,猶豫不定
헤아리다=v.數
헤어지다=v.分開
헬기=n.直升飛機
혀=n.舌頭
현=n.弦
현관=n.家門口,入口
현관문=n.前門,入口
현금=n.現金
현대=現代
현대인=現代人
현대적=n.現代化的
현상=現象
현실=n.現實
현실적=n.現實的
현장=n.現場
현재=現在
현지=n.現場
혈액=n.血液
협력=n.協力合作
형=n.哥哥
형님=哥哥
형부=n.姐夫
형사=n.刑事
형성=n.成
형성되다=形成,變成
형성하다=形成
형수=n.嫂嫂
형식=形式
형식적=n.式上,表面上
형제=n.兄弟姐妹
형태=n.形態
형편=n.情況
혜택=n.恩澤,好處
호=n.號
호기심=n.好奇心
호랑이=n.老虎
호박=n.南瓜
호선=n.地鐵線路
호수=n.湖
호실=n.室,房間
호주=n.澳洲
호주머니=n.口袋
호텔=n.賓館
호흡=n.呼吸
혹시=adv.或許
혹은=或者
혼나다=v.受罪,嚇破膽
혼자=adv.單獨地,獨自地
혼잣말=n.自言自語
홀로=獨自
홈페이지=n.主頁(網站)
홍보=n.宣傳,廣告
홍수=n.洪水
홍차=紅茶
화=火
화가=n.畫家
화나다=v.憤怒
화려하다=adj.華麗的
화면=畫面
화분=n.花盆
화살=n.箭矢
화요일=星期二
화장=n.袖長
화장실=n.洗手間,廁所
화장지=n.衛生紙(洗手間的)
화장품=n.化妝品
화재=n.火災
화제=n.話題
화학=n.化學
확=adv.突然,一下;n.臼
확대되다=擴大,放大
확대하다=擴大
확립하다=確立
확보=n.確保,切實保證
확산되다=擴散
확신=n.確信,堅信
확신하다=信心,確信
확실하다=確實
확실히=確實
확인=n.確實原因
확인되다=確認,確定
확인하다=v.確認
확장=n.擴張,擴充,擴大
확정=n.確定
환갑=花甲
환경=n.環境
환경오염=n.環境污染
환영=n.歡迎
환영하다=歡送
환율=n.匯率
환자=n.患者
환하다=adj.明亮,亮
활기=n.活力
활동=n.活動
활동하다=活動
활발하다=adj.活潑的
활발해지다=活潑,活躍
활발히=活潑
활용=n.活用,利用
활용하다=活用
활짝=adv.盛,怒放(花開)
회=n.回,屆,次
회견=n.會見,會晤,會面
회관=n.會館
회복=n.恢復
회복되다=恢復
회복하다=v.恢復
회사=n.公司
회색=n.灰色
회원=n.會員
회의=n.會議
회장=n.會長,會場
회전=n.旋轉
회화=n.繪畫
횟수=n.次數,回合
횡단보도=n.過街橫道
효과=n.效果
효과적=有效的
효도=n.孝道
효도하다=孝順
효율적=效率的
효자=孝子
후=n.以後
후기=n.勁兒
후반=n.半
후배=n.後輩
후보=n.候補
후춧가루=n.胡椒麵,胡椒粉
후회=n.悔
후회하다=後悔
훈련=n.訓練
훌륭하다=adj.優秀的
훔치다=v.拭,擦
훨씬=adv.(程度)更
휴가=n.休假
휴식=休息
휴일=n.休息日
휴지=n.廢紙
휴지통=n.紙簍
흉내=n.模仿
흐려지다=v.渾濁
흐르다=v.流逝
흐름=n.水流,潮流
흐리다=陰
흑백=n.黑白,是非
흑인=n.黑人
흔들다=模糊
흔들리다=v.震動,搖曳
흔적=n.痕跡
흔하다=多的是
흔히=常
흘러가다=v.逝去,流逝
흘러나오다=v.流出
흘러내리다=v.滾下,流下,傾瀉
흘리다=流
흙=土
흥미=n.興趣
흥미롭다=adj.有興味,有興趣
흥분=n.興奮
흥분하다=興奮
흩어지다=v.分散,散開
희곡=n.戲劇
희다=adj.白,淺白
희망=n.希望
희망하다=希望
희생=犧牲
희생하다=犧牲
흰색=n.白色
힘=n.力氣,力量
힘겹다=adj.吃力的,費勁的
힘껏=adv.盡力
힘들다=adj.艱難
힘들어하다=不好,不易,不費事
힘쓰다=v.用力,努力
힘없이=adv.無力地,沒勁頭地
힘차다=adj.充滿力量,朝氣勃勃,雄糾糾
