가게=store
가격=price
가구=family
가까워지다=get closer
가까이=close
가깝다=close
가꾸다=grow or cultivate
가끔=sometimes
가난=poor
가난하다=poor
가늘다=thin or fine or slender
가능=possibility
가능성=possibility
가능하다=to be possible
가능해지다=to become possible
가다=to go
가득=full
가득하다=to fill
가득히=full
가라앉다=to sink
가령=for example
가로=width or breadth
가로등=a street light
가로막다=interrupt or obstruct
가로수=a roadside tree
가루=powder or flour; meal
가르다=split or divide
가르치다=to teach
가르침=teaching or an instruction
가리다=pile up or stack up or heap up
가리키다=point to or indicate
가만=quietly or softly
가만있다=remain still or motionless
가만히=quietly or softly
가뭄=a drought
가방=bag
가볍다=light
가사=words or lyrics
가상=imagination
가수=singer
가스=gas
가슴=chest
가슴속=one's heart feelings
가요=a song
가운데=in the middle
가위=scissors
가을=autumn or fall
가이드=guide
가입=entrance
가입자=member or subscriber
가입하다=join
가장=most
가정=family
가정교사=private tutor
가져가다=to take or carry
가져다주다=take something to someone
가져오다=to bring or get
가족=family
가죽=the skin or hide or leather
가지=one of the kind or a sort
가지다=to have or take or hold
가짜=fake
가치=price
가치관=one's values or sense of values, a value system
가톨릭=catholic
가하다=to add
각=each or every
각각=each and every
각국=each country
각기=each or severally or respectively
각오=readiness or preparation
각자=each one or every one
각종=all sorts or varieties
간=the interval between
간격=a space or interval
간단하다=to be simple
간단히=simply speaking
간부=the leaders
간섭=interfere or meddle
간식=snack
간신히=narrowly or barely
간장=soy sauce
간접=indirectness
간접적=indirect or mediate
간판=a signboard
간편하다=simplicity or convenience
간호=nursing or care
간호사=nurse
간혹=occasionally or at times
갇히다=be confined or shut up
갈다=sharpen
갈등=conflict or troubles
갈비=the ribs
갈비탕=beef-rib soup
갈색=brown
갈아입다=change one's clothes
갈아타다=transfer
갈증=thirst
감=feelings
감각=sense or sensation or feeling
감기=a cold
감다=close
감독=the director
감동=agitate or stir up the emotions
감동적=sensational
감사=thanks
감사하다=to thank
감상=appreciation
감상하다=to show appreciation
감소=decrease
감소되다=to be reduced or diminished
감소하다=to reduce or diminish
감수성=receptivity or susceptibility
감싸다=wrap up or tuck in
감옥=prison
감자=potato
감정=feelings
감정적=emotional
감추다=hide or conceal
감히=daringly or boldly
갑=the first
갑자기=suddenly
갑작스럽다=all of a sudden
값=price
값싸다=cheap or low-priced
강=river
강남=south of a river
강당=a lecture hall
강도=intensity or strength
강력하다=to be strong or powerful
강력히=with great strengt
강렬하다=intense or strong or severe
강물=river water
강변=a riverside
강북=north of the river
강사=instructor or teacher
강수량=how much rainfall
강아지=puppy
강요하다=insist on
강원도=region surrounding Seoul
강의=a lecture or discourse
강의하다=to give a lecture
강제=compulsion or coercion
강조=emphasis or stress
강조하다=place emphasis upon
강하다=to be strong or powerful
강화하다=strengthen
갖가지=a variety of or all sorts
갖다=to hold
갖추다=make or get ready or prepare
같다=to be similar
같이=together
같이하다=to do together or to share
갚다=pay back a loan
개=unit or piece
개개인=individuals or every person
개구리=frog
개국=the foundation of a country
개나리=a forsythia or a golden-bell tree
개다=to clear up or become clear
개미=ant
개발되다=to be developed or exploited
개발하다=develop or exploit or open up to development
개방=open or throw open
개방되다=to be opened
개방하다=to open or to throw open
개별=an individual or a particular case
개선=renovation or improvement or betterment
개선되다=to be renovated or to get improved
개선하다=to renovate or to improve
개성=individuality or personality
개월=each and every month
개인=private or individual
개인적=private or personal
객관적=objective
걔=child
거=that thing
거기=there
거꾸로=backwards or bottom up or the wrong way
거대하다=huge or gigantic or enormous
거두다=collect or gather up
거들다=help or assist or lend
거듭=again or over and over
거리=distance
거부하다=deny or reject or disapprove
거실=living room
거액=a large sum of money
거울=mirror
거의=almost or nearly
거절하다=refuse or reject
거짓=fabrication or fiction
거짓말=a lie or falsehood
거치다=pass or go through
거칠다=coarse, wild
거품=bubble
걱정=worry
걱정되다=to become worried
걱정스럽다=anxious or uneasy
걱정하다=to worry or be anxious
건=a matter or an object or a case
건강=health
건강하다=to be healthy
건너=the other or opposite side
건너가다=to cross or go over
건너다=go over or go across
건너오다=to come across to this side of something
건너편=the opposite side
건넌방=the room opposite the main living room
건네다=speak to a person or address
건네주다=to pass over or to put on the other side
건드리다=touch or jog
건물=building
건설=construction
건설되다=to become constructed
건설하다=to construct or erect
건전하다=health or soundness or vitality
건조=dryness or aridity
건조하다=become dry
건지다=take or bring out of the water
건축=construction or building or erection
걷기=walking
걷다=to walk
걸다=hang up or suspend
걸리다=to be hung up or suspended
걸어가다=to go on foot or walk
걸어오다=come on foot or walk
걸음=walking or stepping or a step
걸치다=put a thing over or across
검다=black or dark
검사=investigation or inspection or examination or audit
검은색=black or dark
검정색=a large sum of money
검토=an examination or investigation or study
겁=fear or fright
겁나다=be frightened or scared
것=a thing or an object
겉=the outer surface
게=a crab
게다가=in addition
게시판=a notice board or a bulletin board
게으르다=lazy
게임=game
겨우=barely or narrowly
겨울=winter
겨울철=the winter season
겨자=mustard
겪다=experience or undergo or suffer
견디다=endure or bear
견해=an opinion or view
결과=result
결국=after all or in the end
결론=a conclusion
결석=absent
결석하다=to be absent
결승=the decision of the final round of a contest
결심=determination or resolution
결심하다=to resolve or be determined
결정=a decision or determination
결정되다=to become decided
결정하다=to decide
결코=never or by no means
결혼=marriage
결혼식=wedding
결혼하다=get married
경계=boundary
경고=warning
경고하다=to warn
경기=race or match or contest
경기도=region surrounding Seoul
경기장=sports stadium or a sports field
경력=one's personal history
경복궁=region surrounding Seoul
경비=expenses or outlay
경영=management or administration
경영하다=to manage or administer
경우=a case or an instance
경쟁=competition or rivalry
경쟁력=competitiveness
경제=economy
경제력=economic power
경제적=economical
경제학=economics
경주=region surrounding Seoul
경찰=the police
경찰관=a policeman
경찰서=a police station
경치=a scene or scenery
경향=tendency or trend
경험=experience or undergo or suffer
경험하다=to experience or go through
곁=neighborhood or vicinity
계곡=a valley or gorge
계단=a staircase or a set of stairs
계란=an egg
계산=calculation
계산기=calculator
계산하다=to calculate
계속=continuously
계속되다=to continue
계속하다=to continue
계시다=to stay or be located
계약=contract
계절=season
계좌=account
계층=a class or social stratum
계획=a plan or a project
계획하다=plan or make a project
고개=the nape of the neck
고객=customer
고교=high school
고구려=region surrounding Seoul
고구마=sweet potato
고궁=an ancient palace
고급=high rank or first class
고급스럽다=to be high-class
고기=meat
고등학교=a senior high school
고등학생=high school student
고려=region surrounding Seoul
고려하다=regard or respect
고르다=choose or select
고맙다=to thank
고모=a paternal aunt
고모부=the husband of one's paternal aunt
고무신=rubber shoes
고민=worry or anguish
고민하다=be in anguish or worried
고생=a hard life or privation
고생하다=to suffer or to have trials
고소하다=taste of sesame oil or taste of a nut
고속=high speed
고속도로=freeway or highway with no street lights
고속버스=bus for the freeway
고양이=kitten
고요하다=be quiet or silent or still
고작=to be at the highest or the best
고장=a district or producing area
고전=a classic in literature
고집=persistence or stubbornness
고집하다=to be stubborn or persistent
고추=red pepper
고추장=red pepper paste
고춧가루=red pepper powder
고치다=to fix, amend, change
고통=suffering or agony
고통스럽다=be painful or torment
고프다=hungry or famished
고함=a shout or yell
고향=hometown
곡=a tune or an air
곡식=cereals or grain
곤란하다=difficulty or trouble
곧=soon
곧다=be straight or upright or erect
곧바로=at once or straight away
곧이어=soon hereafter
곧잘=fairly or pretty well
곧장=directly or straightforwardly ; to do something straight away
골=goal
골고루=evenly or among all indiscriminately
골목=a side street or alley
골목길=an alley
골짜기=a valley or gorge
골치=worry or anxiety
골프=golf
골프장=golf course
곰=bear
곱다=beautiful
곳=place
곳곳=everywhere
공=ball
공간=space or room
공개=opening to the public, making public
공개하다=open to the public
공격=attack
공격하다=to attack
공공=the public or the common
공군=the air force
공급=supply or provision
공기=air
공동=association or union or collaboration
공무원=public servant
공부=study
공부하다=to study
공사=construction work or engineering work
공식=a formula or formality
공식적=formal or procedural
공업=the industry or manufacturing industry
공연=a public performance
공연되다=to give a public performance
공연장=auditorium
공연하다=offer a performance
공연히=futile or vain or useless
공원=park
공장=construction site
공주=a royal princess
공중=the air or the sky
공중전화=a public payphone
공짜=free
공책=notebook for taking notes and studying
공통=commonness
공통되다=to be common
공통적=commonly
공통점=a common point or a common feature
공포=fear or dread
공항=airport
공항버스=bus to the airport
공해=environmental pollution
공휴일=a legal holiday
과=a lesson or a section or a department
과거=the past
과목=a subject or a lesson
과연=just as one thought
과외=extracurricular work
과일=a fruit
과자=a snack or pastries or candy
과장=the department head
과정=process or course
과제=a subject or a thesis or homework; an exercise
과학=science
과학자=scientist
과학적=scientifically
관객=spectator
관계=connection or relation
관계되다=be affected or influenced by
관계없이=without any relation
관계자=the interested or affected parties
관광=sightseeing or tourism
관광객=a tourist
관광버스=tourist bus
관광지=tourist area
관념=an idea or notion
관람=inspection or viewing
관련=relation or connection or reference
관련되다=be connected or related to
관련하다=to be related to or connected to
관리=management or administration
관리하다=to manage or control or supervise or manage
관습=custom or usage
관심=concern or interest
관심사=a matter of concern and interest
관점=a point of view or a standpoint
관찰=observation or survey
관찰하다=observe or view or watch
관하다=refer to or be about
광경=a spectacle or a sight in 3-D and uncut
광고=advertisement
광장=an open space or a plaza or public square
광주=region surrounding Seoul
괜찮다=to be okay
괜히=in vain or useless or fruitless, for a stupid reason
괴로움=trouble or annoyance or distress
괴로워하다=to distress or trouble
괴롭다=be painful or distressing
괴롭히다=afflict or worry
굉장하다=be grand or magnificent or splendor
굉장히=very much or greatly
교과서=textbook
교내=inside the school
교대=alternation or change
교류=interchange; alternating current
교문=a school gate
교복=school uniform
교사=instructor
교수=teaching or instruction
교실=classroom
교양=culture or education
교외=outside the school or extramural
교육=education
교육비=tuition or the cost of a school education
교육자=an educator
교장=principal
교재=teaching material or instruction materials
교직=the teaching profession
교체=shift or change or alternate
교통=traffic or transportation
교통사고=traffic accident
교포=a Korean living abroad
교환=an exchange
교환하다=to exchange
교회=preach or moral instruction
교훈=edification or giving instructions to
구=9
구15=ward or district
구경=an enjoyable sight or spectacle
구경하다=to watch or enjoy watching
구두=shoes or boots
구르다=roll over
구름=a cloud or the clouds
구멍=a hole
구별=a distinction or a separation
구별되다=to be separated an distinguished
구별하다=to distinguish between a and b
구분=a division or section
구분되다=to be put into sections
구분하다=to divide or to classify
구석=a corner
구석구석=every nook and corner
구성=organization or constitution , the framework of something
구성되다=to be organized
구성하다=to organize or makeup
구속=to arrest or put in detention
구속되다=to be arrested
구속하다=to arrest or restrain
구십=90
구역=a zone or district
구월=September
구입=purchase or buying
구입하다=purchase or buying
구조=construction or structure
구청=a ward or district office
구체적=concretely
구하다=to buy or purchase
국=soup or broth
국가=a state or a nation
국가적=national or state
국기=the national flag
국내=inside the country
국내선=domestic airline
국내외=the inside and outside of a country or home and abroad
국립=government established
국물=soup or broth or gravy
국민=the people or a nationality
국민적=national or for citizens
국사=the history of a country
국산=a country's product
국수=noodles
국어=the national language
국왕=a king or a monarch
국적=nationality or citizenship
국제=international
국제선=international airline
국제적=international
국제화=internationalization
국회=the national assembly
국회의원=a member of the national assembly
군=an army
군대=troops or an army
군데=a place or spot
군사=military affairs
군인=sb. in the military
굳다=harden or become hard
굳어지다=become hard
굳이=firmly or adamantly
굳히다=harden or make hard
굵다=be thick or fat
굶다=to starve or go hungry
굽다=to roast or bake
굽히다=bend or stoop
궁극적=finally, in the end
궁금하다=to wonder or be curious about
권=a volume or a book
권리=a right or a claim to
권위=authority or power
권투=boxing
권하다=advise or persuade
귀=ear
귀가=returning home
귀가하다=to return home
귀국=returning to one's home country
귀국하다=to return to one's home country
귀신=a ghost
귀엽다=to be cute
귀중하다=to be precious
귀찮다=annoying irksome
귀하다=noble or high
귓속=the inner ear
규모=scale or scope or structure
규정=provision or stipulation
규칙=rules or regulations
규칙적=be regular or systematic
균형=balance or equilibrium
그=he
그간=the while or during that time
그거=that thing
그것=that thing
그곳=that place
그나마=even though or nevertheless
그날=that day or that same day
그냥=just because or in that condition
그녀=she
그놈=that person or that guy
그늘=shade
그다음=next
그다지=so much or to that extent
그대=you or thou
그대로=like that
그동안=during that time
그때=then or at that time
그래=so or yes or that's right
그래도=all the same
그래서=and so accordingly
그래야=and so, and then
그래픽=graphic
그램=gram
그러나=however or but still
그러니까=and so it is that
그러다=and so, and then, well
그러면=if so or if that is the case
그러므로=so or hence or therefore
그러하다=to be so or right
그런=such a
그런대로=such as it is or anyways
그런데=but or however
그럴듯하다=be plausible or specious or likely
그럼=certainly or of course.
그렇게=and so. like that
그렇다=that is right or yes.
그렇지=so it is or that is right
그렇지만=but or however
그려지다=draw
그루=a root
그룹=group
그릇=a vessel or receptacle
그리=so or to that extent
그리고=and or and then
그리다=picture or draw a picture
그리로=over there
그리움=yearning or affection
그리워하다=yearn or be attached to
그리하여=and then, and so, and now
그림=a picture
그림자=a shadow or a silhouette or an image
그립다=beloved or sweet or affectionate
그만=that much or a little amount
그만두다=stop or discontinue
그만큼=that much or to that extent
그만하다=be about the same or be neither better nor worse
그분=that person
그사이=the while or the meantime
그이=that person or he or him
그저=still or all the time
그저께=the day before yesterday
그전=former days or the past
그제서야=then
그제야=for the first time or not…until
그중=among the rest of them
그쪽=those people
그치다=stop or cease or halt
그토록=so much or to such an extent
그해=that year
극=drama or play
극복=conquest or subjugation
극복하다=to overcome or surmount
극작가=a dramatist
극장=theater or playhouse
극히=exceedingly or extremely
근거=basis or foundation
근거하다=to base sth on sth
근데=but or however
근래=of late or recently
근로=labor or exertion
근로자=laborer
근무=duty or service or work
근무하다=work or labor
근본=the foundation or basis
근본적=foundational, fundamental
근원=the origin or root or source
근육=muscles
근처=nearby or the vicinity
글=words, a verse
글쎄=now or well or let me see
글쎄요=now or well or let me see
글쓰기=writing
글씨=handwriting
글자=a letter or a character
긁다=scratch or scrape
금=gold
금강산=the diamond mountains
금고=a safe or strongbox
금년=this year
금메달=gold medal
금방=just now or a moment ago
금세=in a moment or at once
금액=amount of money
금연=prohibition of smoking
금요일=Friday
금지=forbidden or prohibited
금지되다=to be forbidden or prohibited
금지하다=to restrain or prohibit
금하다=suppress or restraint
급=class or grade or rank
급격히=be rapid or sudden
급속히=rapidly or swiftly
급증하다=surge or sudden rapid increase
급하다=be urgent or pressing or imminent
급히=fast or quickly or in a hurry
긋다=draw or mark
긍정적=affirmation or admission
기13=energy
기23=a flag or a banner
기간=a period or a time or
기계=an instrument or a machine
기관=an engine or a machine
기구=structure or framework
기기13=machinery and tools
기념=commemoration
기념일=commemoration day
기념하다=commemorate
기능=function or functionality
기다=crawl or creep
기다리다=to wait
기대=expectation
기대다=to rely upon or lean upon
기대되다=to be expected
기대하다=to expect or look forward to
기도=a prayer
기도하다=to pray
기독교=Christianity
기둥=a pillar
기록=a record or a document
기록되다=to be recorded or written down
기록하다=to record and write down
기르다=educate or train or cultivate
기름=oil or fat
기막히다=be at a loss for words
기법=techniques
기본=a foundation
기본적=fundamental or basic
기분=mood
기뻐하다=be pleased or delighted with
기쁘다=to be happy
기쁨=joy or delight
기사=an article or an account
기성08=to be already existing or established
기성세대=old people
기숙사=a hostel or residence hall
기술=art or technique or ability
기술자=technician
기술하다=to describe or give an account of
기억=a memory
기억나다=to memorize
기억되다=to be remembered
기억하다=to recall or remember
기업=an enterprise or business
기업인=businessman
기여=contribution or service
기여하다=contribute or add much to
기온=temperature
기운=strength or might
기울다=to tilt or lean
기울이다=tip or slant or incline
기원=origin
기자=a journalist
기적=a miracle
기준=a standard or basis
기차=a train
기초=the foundation
기초적=fundamental or basic
기초하다=make the basis for
기침=coughing
기타=the others or the rest
기호=taste or likes
기혼=married
기회=an opportunity
기획=planning
기후=climate or weather
긴급=emergency
긴장=tension
긴장감=feeling of tension
긴장되다=be under tension
긴장하다=to become tense
길=road
길가=the roadside
길거리=a street
길다=to be long
길어지다=to become long
길이=length or extent
김=seaweed, laver
김밥=roll of rice and vegetables
김치=spicy cabbage
김치찌개=spicy cabbage soup
김포공항=Kimpo domestic airport
깊다=deep
깊숙이=deep or far
깊이=deepness
까다=peel or husk
까닭=reason
까만색=black
까맣다=black
까먹다=crack or peel and eat
까치=magpie
깍두기=sliced white radish kimchee
깎다=cut or trim
깔끔하다=be sleek and smart
깔다=to pave, lay down a floor, spread a blanket etc.
깔리다=to be spread or overspread
깜빡=with a flash or twinkle
깜짝=with a surprise
깡패=gangster
깨끗이=clean or neatly
깨끗하다=to be clean or pure
깨끗해지다=become clean
깨다=wake up from sleep
깨닫다=to realize sth
깨달음=realization
깨뜨리다=to break or crush
깨소금=powdered sesame mixed with salt
깨어나다=return to consciousness
깨어지다=to waken
깨우다=to wake up or awaken
깨지다=to break
꺼내다=to get out or draw out
꺼지다=to go or die out
꺾다=break off or snap off
껌=gum
껍질=skin or nutshell
꼬리=tail
꼬마=a dwarf
꼭=for sure
꼭대기=the top
꼴=shape or form or appearance
꼼꼼하다=very careful or meticulous, doing it in a very detailed manner
꼼짝=cannot move
꼽히다=to be elected
꽂다=be stuck in or insert
꽃=flower
꽃씨=flower seed
꽃잎=a petal
꽉=tightly or fast
꽤=fairly or considerably
꾸다=borrow or loan
꾸리다=pack up or bundle up
꾸미다=decorate
꾸준하다=be steady or unflagging
꾸준히=untiringly, ceaselessly
꾸중=scolding, a rebuke
꿀=honey or nectar
꿈=a dream
꿈꾸다=to dream
꿈속=in a dream
끄다=put out or extinguish
끄덕이다=nod
끈=a string or a cord
끊기다=to be cut off or severed
끊다=cut off or sever
끊어지다=to break off or expire or be done with
끊임없다=to not end
끊임없이=constantly or unceasingly
끌다=pull
끌리다=to be drawn or pulled or dragged
끌어당기다=to draw near
끓다=boil or simmer
끓이다=boil or heat or make hot
끝=the end
끝나다=to draw to a close or to end
끝내=the end
끝내다=to end
끝없다=endless or unfathomable
끝없이=boundlessly
끼=a meal or a repast
끼다=to put on or wear, to wear a ring
끼어들다=interrupt
끼우다=to put between or insert
나=me
나가다=to go out
나누다=to divide
나누어지다=to become divided
나뉘다=divide
나다=to be born
나들이=going out, an outing ; making a short visit to sb. or somewhere
나라=a country
나란히=in a line, row
나르다=to move a long or semi-long distance
나름=depending on
나머지=the rest, the remainder ; as a result of the excess of, as a result
나무=tree
나물=herbs, wild greens
나뭇가지=a tree branch
나뭇잎=tree leaves
나비=butterfly
나빠지다=to become worse
나쁘다=to be bad
나서다=come out, come forth
나아가다=advance, go forward
나아지다=become better, be improved
나오다=come out
나이=age
나중=the last, the latter part
나침반=a compass
나타나다=come out, appear
나타내다=show, display
나흘=four days
낙엽=fallen dead leaves
낚시=fishing
낚시꾼=an angler
낚싯대=a fishing rod
난리=a war, revolt
난방=a heated room
날=day
날개=the wings
날다=to fly
날리다=to send flying
날씨=weather
날아가다=to fly away
날아다니다=fly about
날아오다=come flying
날짜=date
날카롭다=sharp
낡다=clear
남=others, other people
남기다=to leave behind
남녀=man and woman
남다=remain, be left over
남대문=Seoul’s old south gate
남대문시장=shopping center in Seoul
남동생=younger brother
남매=brother and sister
남미=south America
남부=the south part
남북=north and south
남산=mountain in south central Seoul
남성=male
남자=boy
남쪽=south side
남편=husband
남학생=male student
납득하다=to convince, persuade oneself
낫다=superior
낭비=waste
낮=daytime
낮다=be low
낮아지다=become lower
낮추다=lower, make low
낯설다=to be unfamiliar with, to be a stranger to
낱말=a word
낳다=to give birth
내=inside
내과=internal medicine
내내=all along, the entire time
내년=next year
내놓다=put out, take out
내다=produce something
내다보다=look out for
내달=next month
내려가다=to go down
내려놓다=set or put down
내려다보다=overlook
내려오다=come down
내려지다=to become lower
내리다=descend
내밀다=to push out
내버리다=throw away
내보내다=let out, let go out
내부=the inside
내쉬다=exhale
내외=men and woman, husband and wife
내용=contents
내용물=contents
내일=tomorrow
내적=internal
내주다=take out and give away
내지=from a to b
내후년=the year after next year
냄비=a pot
냄새=smell
냇물=a stream, brook
냉동=refrigeration
냉면=cold noodles soup
냉방=a cold or unheated room
냉장고=freezer
너=you
너머=beyond, on the other side
너무=too much
너무나=extremely
너희=you guys
넉=the fourth
넉넉하다=to be enough
널리=widely
넓다=broad
넓어지다=get wider
넓히다=widen
넘겨주다=hand over
넘기다=pass over, send across
넘다=cross or go across
넘어가다=cross or go over
넘어뜨리다=throw down
넘어서다=pass over
넘어오다=fall, come down
넘어지다=fall down, collapse
넘치다=overflow
넣다=put in, set in
네=yes
네거리=crossroads
넥타이=necktie
넷=4
넷째=fourth
녀석=fellow
년=year
년대=year
년도=year
년생80=year of birth
노동=labor, work
노동자=laborer, worker
노란색=yellow
노랗다=be yellow
노래=song
노래방=singing room
노래하다=to sing
노랫소리=a singing voice
노력=effort
노력하다=to try hard, strive
노선=route
노인=old person
노트=a note
녹다=to melt
녹색=green
녹음=recording
녹음하다=to record
녹이다=melt, dissolve
녹차=green tea
녹화=tree-planting
논=a rice field
논리=logic
논리적=logical
논문=dissertations , an academic paper
논의하다=discussion
논쟁=controversy, argument
논하다=argue, discuss, debate
놀다=play, amuse oneself
놀라다=be surprised
놀랍다=to be surprising
놀리다=banter, tease
놀이=play, game
놀이터=playground
놈=a fellow
농구=basketball
농담=a joke
농민=a farmer
농부=a farmer
농사=farming
농사일=farming
농사짓다=to do farming
농산물=agricultural products
농업=agriculture
농장=a farm, plantation
농촌=a farm village
높다=high
높아지다=become high
높이=height
높이다=raise, elevate
놓다=put, place
놓아두다=leave as it is, let it be
놓이다=be put on sth else
놓치다=miss, let slip
놔두다=leave as it is, let it be
뇌=brains
누구=who
누나=older sister
누르다=press or push down
눈=eyes
눈가=the eye rims
눈감다=close the eyes
눈길=line of vision
눈동자=the pupil
눈뜨다=open one's eyes
눈물=a tear
눈병=an eye disease
눈부시다=to be dazzling
눈빛=the glitter of one's eyes
눈썹=the eyebrow
눈앞=before one's eyes
눕다=lie down
뉴스=news
뉴욕=New York
느껴지다=feel
느끼다=to feel
느낌=touch, feel
느리다=be slow, tardy
늑대=wolf
늘=always
늘다=increase, gain
늘리다=increase, multiply
늘어나다=grow longer
늘어놓다=scatter about haphazardly
늘어서다=stand in a row
늘어지다=be lengthened
늙다=grow old
능동적=activity ; voluntary, of its own nature
능력=ability, capability, how much and how well
늦가을=late autumn
늦다=to be late
늦어지다=to become late
다=all, everything
다가가다=to get near to
다가서다=step up, go near to, come closer
다가오다=approach
다녀가다=drop in for a short visit
다녀오다=drop in for a short visit
다니다=go to and from a place
다듬다=trim, shave
다루다=treat, deal with
다르다=be different
다른=different
다름없다=be similar, not different
다리=leg
다만=only, merely
다방=tea room
다섯=5
다섯째=fifth
다소=large and small
다수=a great number
다시=again
다양성=variety
다양하다=to be various, diverse
다양해지다=to be various
다음=next
다이어트=diet
다정하다=to be affectionate, warm-hearted
다지다=make sure, to harden oneself
다짐하다=pledge, vow, swear
다치다=to hurt
다투다=quarrel
다툼=a quarrel
다하다=finish, go through, be exhausted, run out of
다행=good luck
다행히=fortunately
닥치다=shut the mouth!
닦다=wipe clean, polish
단=only one, alone
단계=a step, phase
단골=custom, connection
단단하다=be hard, solid
단독=independence
단맛=a sweet taste
단순=simplicity
단순하다=be simple-minded
단순히=simply
단어=word
단위=a unit, a monad
단점=a weak point
단지=simple, merely
단체=a corps, a group
단추=a button
단편=a piece, fragment
단풍=fall foliage
닫다=to close
닫히다=to shut, be closed
달=the moon
달걀=an egg
달다=to attach, fix
달라지다=to change, vary
달래다=calm down
달러=dollar
달려가다=run, rush, dash
달려들다=run, rush, jump at
달려오다=come running
달력=a calendar
달리=differently
달리기=a run, a spin
달리다=run, make do fast
달빛=moonlight
달아나다=escape, flee
닭=chicken
닭고기=chicken meat for eating
닮다=resemble
담=a wall, fence
담그다=soak in water
담기다=be put food in a bottle or for pickling
담다=put in a bottle
담당=charge, undertaking
담당자=person in charge
담당하다=take charge of
담배=tobacco
담요=a blanket
담임=charge, duty
답=answer
답답하다=feel anxious
답변=an answer
답장=an answer
답하다=answer, reply
닷새=five days
당근=a carrot
당기다=pull
당당하다=dignified
당분간=for the present
당시=at that time
당신=formal you
당연하다=be natural, be no wonder
당연히=of course
당장=on the spot, immediately
당하다=have, encounter
당황하다=be confused
닿다=to reach, get to
대=era, period
대가=a price, cost, charge, consideration, purchase money, value
대강=general principles
대개=mostly, for the most part
대구=Daegu city
대규모=on a large scale
대기=the atmosphere
대기업=big enterprise
대기하다=be ready for the opportunity
대낮=broad daylight
대다=put, place up to
대다수=a large majority
대단하다=considerable, grand
대단히=extremely
대답=an answer
대답하다=to answer, reply
대도시=large city
대략=an outline, summary
대량=a large quantity
대로=like, according to
대륙=a continent
대문=a big gate
대부분=most
대비=provision, preparation
대비하다=provide for
대사=speech, dialogue
대사관=embassy
대신=instead of
대신하다=relieve, replace another
대여섯=about five or six
대응=confrontation, opposition
대응하다=cope or correspond to
대장=a seal, stamp
대접=treatment
대접하다=treatment
대중=the masses
대중교통=mass transportation
대중문화=pop culture
대중적=of the masses
대책=countermeasure
대처하다=disposal, treatment
대체=an outline, summary
대체로=generally, on the whole, for the most part
대출=lending
대충=almost, nearly, about
대통령=the president
대표=representative
대표적=representative
대표하다=represent
대하다=face, confront
대학=university
대학교=university
대학교수=university professor
대학생=university student
대학원=graduate school
대한민국=Korea
대합실=a waiting room
대형=large, full-sized
대화=conversation
대화하다=to converse
대회=a great meeting
댁=you and your family
댐=dam
더=more
더러워지다=get dirty
더럽다=foul, dirty
더불다=join in, do together
더욱=more and more
더욱더=more and more and more
더욱이=besides, moreover
더위=the heat
더하다=get worse
덕=virtue, morality
덕분=indebtedness
던지다=to throw
덜=less, incompletely
덜다=save, lighten
덥다=be hot, heated
덧붙이다=add a thing, append
덩어리=a lump, a cluster
덮다=to cover, veil
덮이다=be covered
데=place, point, instance
데려가다=take with
데려오다=go with
데리다=be accompanied by
데우다=to warm, to heat up
데이트=date
도=degrees
도구=tool, instrument
도달하다=arrival
도대체=in the world, on earth
도덕=immorality
도둑=a thief, a burglar
도로=a road, way
도리어=on the contrary
도마=a chopping board
도망=escape
도망가다=make a go for it, escape
도망치다=to make an escape
도서관=library
도시=city
도시락=lunchbox lunch
도심=the heart of the city
도와주다=to help
도움=help
도움말=helping words
도입=introduction, invitation
도자기=porcelain
도저히=by all means
도전=challenge, defiance
도중=on the way
도착=arrival
도착하다=to arrive
도쿄동경=Tokyo
독감=influenza
독립=independence
독립하다=to become independent
독서=reading
독일=Germany
독일어=German
독창적=original
독특하다=unique, characteristic, distinctive, peculiar, specific
독하다=be poison
돈=money
동=the same
동그랗다=to be circular
동화책=a fairy tale
되돌아보다=to look back on
두세=two or three
두어=about two, a couple
뒷모습=the features of the back side
뒷산=the back side of a mountain
들다=means continuing the main verb's action ; to enter
들려오다=to echo
듯=to be like something
듯싶다=to be like something, I guess
따스하다=feel warm
딸아이=daughter
땅속=in the soil
떠나오다=to come back from the us
마구=continuously, without pause
마누라=one's wife
마늘=garlic
마당=garden
마디=a word, a tune, a song, a paragraph
마땅하다=be right, appropriate
마라톤=marathon
마련=planning, making arrangements ; provisions, preparations
마련되다=to be planned and arranged
마련하다=to plan, arrange
마루=a wooden floor, floor, flooring
마르다=become dry
마리=number of animals
마무리=finish, completion
마사지=massage
마시다=to drink
마약=a drug
마요네즈=mayonnaise
마을=town
마음=heart
마음가짐=mental attitude
마음껏=as much as you want
마음대로=as you wish
마음먹다=be determined to
마음속=deep in one's heart
마음씨=disposition, nature
마이크=mike
마주=face to face
마주치다=collide with
마중=meeting, reception
마지막=last, final
마찬가지=the same
마찰=rubbing, chafing
마치=as though, as if
마치다=finish, complete
마침=just, exactly
마침내=finally, in the end
마크=a company logo
마흔=forty
막=carelessly, at random
막걸리=a slightly bitter soju drink
막내=the lastborn
막다=stop, obstruct
막상=really, actually
막히다=be stopped up
만=as many as, full, complete
만나다=meet
만남=a meeting
만두=Chinese dumplings
만들다=to make
만들어지다=make, create
만만하다=be soft, tender ; to be easy to handle, deal with
만세=10, 000 years
만약=if
만일=if, suppose
만점=perfect score
만족=satisfaction
만족스럽다=satisfied
만족하다=to be content
만지다=to touch
만큼=of that amount
만하다=be of the extent of
만화=cartoons
만화가=cartoon artist
많다=many, much
많아지다=become a lot
많이=a lot
말=words, speaking
말기=the end, final period
말다=cease
말리다=dry sth
말씀=speech
말씀드리다=speak
말씀하다=speak
말없이=at a loss for words
말투=one's way of talking
말하다=speak
맑다=clean, pure
맘=heart
맘대로=as you want
맛=flavor
맛보다=taste
맛없다=bad flavor
맛있다=delicious
망설이다=hesitate
망원경=telescope
망치다=ruin
망하다=go to ruin
맞다=be right, correct; to match, be fitting for
맞서다=stand opposite
맞은편=the other side of this is one word
맞이하다=go to greet
맞추다=adjust, adapt
맡기다=entrust sb. with sth
맡다=take charge of
매=whip, rod, cane
매너=manner
매년=every year
매다=tie
매달=every month
매달다=bind up, hang
매달리다=be suspended, to be hanging down; to stick to a job, to persevere
매력=fascination, charm, bewitchery
매번=every time
매스컴=mass communication
매우=very
매일=every day
매장=a store, shop
매주=every week
매체=a medium, medias
맥주=beer
맨=bare, naked
맵다=spicy
맺다=form, tie
머리=head
머리말=a preface
머리카락=head hair
머리칼=hair
머릿속=inside one's head
머무르다=stay overnight
머물다=stay overnight
먹고살다=make one's living
먹다=eat, chow down on
먹이=food
먹이다=support, feed
먹히다=to be eaten, swallowed
먼저=first
먼지=dust
멀다=to be far
멀리=far away
멀어지다=become distant to
멈추다=stop
멋=smartness
멋있다=stylish, tasteful
멋지다=be splendid
멍멍=a bruise
멎다=stop
메뉴=menu
메다=put on one's shoulder
메모=memo
메시지=message
메우다=to carry, attach; put on
메일=mail
며느리=daughter-in-law
며칠=how many days
면=side
면담=an interview
면적=area, dimensions
면접=interview
면하다=escape, avoid
멸치=anchovy
명=person counter
명단=list of names
명령=an order, command
명령어=directive
명예=honor
명의=name, title
명절=festival days
명칭=a name, title
명함=name card
명확하다=clear, precise
몇=a few
몇몇=several
몇십=in the tens
모=a certain person, Mr. jones
모금=money raising
모기=a mosquito
모니터=monitor
모델=model
모두=everybody
모든=every one
모래=sand
모레=the day after tomorrow
모르다=to not know
모범=model, example
모색하다=evening twilight
모습=shape, body
모시다=attend on
모양=a shape, form
모여들다=gather, flock
모으다=gather, get together
모이다=meet, assemble
모임=a group, a party
모자=a hat
모자라다=to be insufficient
모조리=one and all, wholly
모집=collection
모집하다=call for
모처럼=at long last
모퉁이=corner
목=the neck
목걸이=necklace
목록=catalogue
목사=a pastor
목소리=voice
목숨=life
목요일=Thursday
목욕=a bath
목욕탕=a bathhouse
목적=goal, purpose
목표=goal, object
몰다=drive ; to chase or urge on
몰래=secretly, quietly
몰려들다=be driven into
몰려오다=come in crowds
몸=body, physique
몸매=one's figure
몸무게=body weight
몸살=flu aches and pains
몸속=in one's body
몸짓=a gesture
몸통=the trunk, body
몹시=extremely
못=cannot
못되다=to go wrong
못생기다=ugly
못지않다=be just as good as
못하다=be impossible
묘사=description
묘사하다=to describe
무=radish
무겁다=heavy ; a stuffy atmosphere
무게=weight
무관심=indifference, unconcern
무관심하다=be indifferent to
무궁화=the rose of Sharon
무기=weapon
무너지다=collapse
무늬=pattern
무대=stage
무더위=high humidity
무덤=a grave, tomb
무덥다=sultry, sweltering
무려=as many as, no less than
무렵=the time when
무료=free
무릎=a knee
무리=be unreasonable
무리하다=be impossible
무사하다=be safe, peaceful
무섭다=fearful, dreadful
무슨=what, what kind of
무시하다=disregard, ignore ; to be defiant and fail to observe
무어=what?
무엇=that thing, whatever
무역=trade
무용=dancing, a dance
무용가=dancer
무의미하다=be nonsense
무조건=unconditional
무지개=a rainbow
무책임하다=not responsible
무척=extremely
묵다=get old
묶다=bind, tie
묶이다=be fastened together
문=door
문구=passage, paragraph
문득=suddenly
문밖=outside the door
문법=grammar
문서=a document
문자=letters, character
문장=writing, composition
문제=question, problem
문제되다=become a problem
문제점=the point at issue
문학=literature
문학적=literary
문화=culture
문화재=cultural assets
문화적=cultural
묻다=to ask
묻히다=get buried
물=water
물가=prices of products
물건=a thing
물결=a wave
물고기=fish
물기=moisture
물다=bite, put in the mouth
물러나다=fall back, to pull back, to pull back your position
물론=of course
물리학=physics
물속=inside the water
물어보다=ask
물음=a question
물질=matter, material
물질적=material
물체=a material body
뭘=what
뭣=what
미=beauty, grace
미국=America
미끄러지다=slippery
미끄럽다=to be slippery
미니=mini
미디어=media
미래=future
미루다=postpone
미리=beforehand
미만=under, below ; less than
미사일=missile
미소=smile
미술=art, the fine arts
미술관=fine arts museum
미스=miss
미안하다=to be sorry
미역=brown seaweed
미용실=beauty salon
미움=hatred
미워하다=dislike
미인=a beautiful girl
미처=to that extent
미치다=to reach
미터=meter
미팅=meeting
미혼=unmarried
민간=civil, private
민속=folk-customs
민족=race, nation, people
민주=democracy
민주주의=democracy
민주화=democratization
믿다=believe
믿어지다=become believable
믿음=belief
밀가루=flour
밀다=push, shove
밀리다=to be left undone, to be late in making a payment
밀리미터=millimeter
밀접하다=be close, intimate with
밉다=be detestable
및=as well as
밑=the bottom
밑바닥=the bottom, base
바=a thing, what
바가지=a gourd dipper
바구니=basket
바깥=outside
바깥쪽=the outside
바꾸다=change, exchange
바뀌다=be changed
바나나=banana
바늘=a needle, pin
바다=sea
바닥=floor
바닷가=the beach
바닷물=sea water
바라다=wish, hope
바라보다=look at, watch ; to look forward to, hope for
바람=wind
바람직하다=be desirable, advisable, to be appropriate, good
바로=right, correctly
바로잡다=straighten
바르다=be straight; be honest
바보=ignorant
바쁘다=busy
바싹=completely
바위=a rock, a crag
바이러스=virus
바이올린=violin
바지=pants
바치다=give, offer
바퀴=wheel
바탕=natural disposition ; to go all out in a fight, 아주 크게 싸우다 ; the background
박=staying the night
박다=drive, hammer in
박물관=museum
박사=doctor
박수=applause
박스=box
박히다=be nailed in
밖=the outside
반=half
반갑다=be happy
반기다=rejoice, be glad of
반대=opposite and being opposed to
반대편=the opposite side
반대하다=be opposed to
반드시=most certainly
반말=crude language
반면=one side
반발=repulsion, a backlash
반복되다=to be repeated
반복하다=to repeat
반성=reflection
반성하다=examine oneself
반영하다=reflect, be reflected
반응=reaction
반장=squad leader
반죽=kneading; dough
반지=ring
반짝거리다=twinkle-twinkle
반짝이다=shine, glitter
반하다=to be contrary to
받다=receive
받아들이다=accept
받침=support, prop
발=foot
발가락=a toe
발걸음=gait, step
발견=discovery
발견되다=be discovered
발견하다=to discover
발길=a kick; walking pace, steps
발끝=on tiptoes
발달=development, growth
발달되다=be developed
발달하다=to advance
발등=the instep of the foot
발레=ballet
발목=ankle
발바닥=the sole of the foot
발생=birth
발생하다=originate, come from
발음=pronunciation
발음하다=pronounce
발자국=footprint
발전=development
발전되다=be advanced, prospering
발전하다=to develop, grow
발톱=a toenail
발표=announcement
발표되다=be announced
발표하다=to announce
발휘하다=display, exhibit
밝다=to be promising
밝아지다=become bright
밝혀내다=to find out
밝히다=to light up
밟다=step on
밤=night
밤낮=night and day, always
밤늦다=it is late at night
밤새=all night
밤새다=to stay up all night
밤새우다=sit up all night
밤색=chestnut color, maroon
밤중=midnight
밤하늘=night sky
밥=rice, a meal
밥맛=appetite
밥상=dinner table
밥솥=pressure cooker for rice
방=a room
방금=just now
방면=direction
방문=a visit
방문하다=to visit
방바닥=room's floor
방법=way, method
방송=broadcast
방송국=broadcasting station
방송사=broadcasting company
방송하다=broadcast
방식=a form, method, process
방안=a plan, scheme
방울=a drop
방지=prevention, check
방지하다=to prevent, check
방학=school holidays
방해=an obstacle, hindrance
방해하다=interrupt, interfere
방향=direction
밭=a field, farm
배=a boat
배경=background
배고프다=to be hungry
배구=volleyball
배꼽=the navel
배다=soak into
배달=delivery
배드민턴=badminton
배부르다=to be full
배우=actor
배우다=to learn
배우자=a mate, life partner
배추=Chinese cabbage
배추김치=pickled cabbage
배치=arrangement
백=hundreds of
백두산=Korean mountain
백색=white
백성=the common people
백인=Caucasian
백제=historical Korean government
백화점=department store
뱀=snake
뱃사람=a seaman, sailor
뱉다=spit
버려지다=take away, throw away to somewhere
버릇=habit
버리다=throw away
버섯=mushroom
버스=bus
버터=butter
버튼=button
버티다=endure, tolerate
번=number, how many times
번개=lightning
번거롭다=be troublesome
번역=translation
번역하다=to translate
번지=area of land
번째=how many times
번호=a number
벌=punishment
벌금=a fine
벌다=to earn
벌떡=suddenly, abruptly
벌레=a bug
벌리다=open, wide
벌써=already
벌어지다=to get serious, enlarge
벌이다=to plan to start a job
범위=range, area
범인=a criminal
범죄=a crime
법=a law, the law
법률=a law, statute
법원=court of justice
법적=legal
법칙=a law, a rule
벗기다=unclothe, undress
벗다=take off, remove
베개=a pillow
베다=cut, chop
베이징북경=Beijing
벤치=bench
벨트=belt
벼=a rice plant
벽=a wall
변경=change, alteration
변동=change, fluctuation
변명=explanation, vindication
변신=disguise, transformation
변하다=change
변호사=lawyer
변화=change, transformation
변화되다=to be changed
변화하다=to change, vary
별=a star
별다르다=be of a peculiar kind
별도=a separate way
별로=especially, particularly
별명=nickname, alias
별일=a particular thing
병=sickness
병들다=get sick
병실=an infirmary
병아리=chick, baby chicken
병원=hospital
보고=report, information
보고서=report
보고하다=report to a person
보관=custody, deposit
보관하다=keep in one's custody
보내다=send
보내오다=receive
보너스=bonus
보다=to try
보도=news, report
보도되다=to be reported
보도하다=to report, inform
보라색=purple
보람=worth, result
보름=15 days, the 15th day
보리=barley
보살피다=take care of
보상=compensation
보수=conservation
보수적=conservative
보안=preservation of the public peace
보완하다=to supplement and make complete, to complement sth
보이다=see, catch sight of
보자기=a diver
보장=guarantee, security
보장되다=be secured
보장하다=to secure, guarantee
보전=integrity, preservation
보조=assistance, aid
보존=preservation
보존하다=preserve, conserve
보충하다=replenish, replace, fill up
보통=the normal
보편적=universal
보험=guarantee, insurance
보호=protection, shelter
보호되다=to be protected
보호하다=protect, shelter, guard
복=luck, happiness
복도=a corridor
복사=reproduction
복사하다=reproduce, copy
복숭아=peach
복습=reviewing
복습하다=to review
복잡하다=be complicated
볶다=fry, roast
볶음=roasted sth
볶음밥=frizzled rice
본=an example
본격적=exemplary
본래=originally, primarily
본부=the headquarters
본사=main office
본성=original nature or character
본인=person in question
본질=true nature, essence
볼=cheek
볼링=bowling
볼일=business, errand, engagement
볼펜=a ball pen
봄=spring
봉사=service, attendance
봉사하다=serve, render service
봉지=bag
봉투=envelope
뵈다=contraction of
뵙다=see, meet
부=a department, a part
부근=neighborhood, vicinity
부끄러움=shame, disgrace
부끄럽다=be shameful, disgraceful
부담=a burden, responsibility
부담하다=bear, shoulder a responsibility
부대=a detachment, squad
부동산=real estate
부드럽다=soft, tender
부딪치다=collide with, bump against
부딪히다=be bumped into
부러워하다=envy, be envious of
부러지다=break, get broken
부럽다=be enviable
부르다=to call
부모=parents
부모님=parents
부문=a section, department
부부=man and wife
부분=part, portion
부분적=departmental
부산=Busan, city in Korea, with largest beach in Korea
부상=a wound, injury
부서=one's post, duty
부서지다=break, be broken
부엌=kitchen
부위=a region, part
부인=a woman
부자=a rich person
부작용=reaction, side effect
부잣집=rich man's house
부장=head of a department
부재=absence
부정=injustice, wrongfulness
부정적=negative, contradicting sth else, not positive
부정하다=be uncertain, irregular
부족=a tribe
부족하다=be short of, lack
부지런하다=be diligent
부지런히=diligently
부채=a debt, liabilities
부처=Buddha
부치다=to send, to post
부친=a father
부탁=request, favor
부탁하다=ask sb. a favor
부품=parts, accessories
부피=bulk, size
부회장=a vice president
북=north
북부=the north part
북쪽=the north direction
북한=north Korea
분=minutes
분노=rage, anger
분량=quantity, measure
분리=separation
분리되다=to be segregated
분리하다=to separate, break away from
분명=obviousness
분명하다=to be clear
분명해지다=to become clear
분명히=obviously
분석=analysis
분석하다=to analyze
분야=field
분위기=atmosphere, surroundings
분주하다=be busy, crowded
분포하다=distribution
분필=chalk
분홍색=pink color
불=fire
불가능하다=impossible
불가피하다=inevitable, unavoidable
불고기=roast meat
불과=only, not more than
불과하다=nothing more than
불교=Buddhism
불구하다=deformity, malformation
불꽃=flame, blaze, spark
불다=blow
불러일으키다=rouse, stir up
불리다=to be called
불리하다=to be disadvantageous, unfavorable to
불만=dissatisfaction
불법=illegal
불빛=fire light
불쌍하다=to be deplorable
불안=uneasiness, anxiety
불안하다=to be uneasy, anxious
불어오다=call to come
불이익=disadvantage, drawback
불편=inconvenience
불편하다=to be unpleasant
불평=dissatisfaction
불평등하다=inequality
불필요하다=to be unnecessary
불행=unhappiness
불행하다=do not permit
불확실하다=be uncertain
붉다=be red
붐비다=be congested, crowded ; to be full of
붓다=to pour
붙다=stick, adhere to
붙들다=catch, seize, grasp
붙이다=affix, put on
붙잡다=seize, catch
붙잡히다=be caught
브랜드=brand
블라우스=blouse
비=rain
비교=a comparison
비교적=comparatively
비교하다=to compare
비극=a tragedy
비기다=end in a tie, to be even-even
비난=criticism, reproach
비누=soap
비닐=a thin sheet of plastic, vinyl
비닐봉지=plastic bag
비다=to be empty, vacant
비둘기=pigeon
비디오=video
비로소=for the first time
비롯되다=to be begun, to have started
비롯하다=begin, start
비만=fatness, corpulence
비명=a scream
비밀=a secret
비바람=rain and wind
비비다=rub, chafe
비빔밥=vegetarian dish of rice and vegetables
비상=emergency
비서=secretary
비슷하다=to resemble
비싸다=to be expensive
비용=expense
비우다=empty, vacate
비웃다=laugh at, ridicule
비율=ratio, percentage
비중=specific gravity
비추다=shed, throw light on
비치다=shine
비키다=move aside
비타민=vitamin
비판=criticism, a comment
비판적=critical
비판하다=to criticize
비하다=compare to
비행=flying, aviation
비행기=an airplane
비행장=an airfield
빌다=pray, wish, ask
빌딩=building
빌리다=to lend
빗=a comb
빗물=rainwater
빗방울=raindrops
빗줄기=great streaks of rain
빚=debt
빛=light
빛깔=a color, shade, hue
빛나다=shine, glitter
빠뜨리다=throw into; entice, entrap
빠르다=be fast, quick
빠져나가다=get out of here
빠져나오다=come out of somewhere
빠지다=to fall into
빨간색=deep-red, crimson
빨갛다=deep-red, crimson
빨다=sip, suck
빨래=washing, laundry
빨리=quickly
빵=bread
빼놓다=exclude, leave out
빼다=pull out, extract
빼앗기다=a thing be taken away
빼앗다=take away from
뺏다=straight
뺨=cheek
뻔하다=almost, nearly
뻗다=stretch out, extend beyond
뼈=a bone
뽑다=pull out, draw
뽑히다=be taken out, pulled out
뿌리=a root
뿌리다=sprinkle, scatter
뿌리치다=shake off, refuse
뿐=only, alone, merely
사=four, the fourth
사건=an event, incident
사계절=the four seasons
사고=an accident
사과=an apple
사과하다=to apologize
사귀다=make friends with
사기=morale, fighting spirit
사나이=a man, a male
사냥=hunting, a hunt
사다=to buy, purchase
사들이다=buy, purchase
사라지다=to disappear
사람=person
사랑=love
사랑스럽다=lovely
사랑하다=to love
사례=thanks, gratitude
사립=private
사망=death
사망하다=to decease, pass away
사무=office work
사무소=office
사무실=office
사무직=working in the office not in the factory
사물=objects, things
사방=the four directions
사상=in history
사생활=private life
사설=an editorial
사소하다=be trifling, insignificant
사슴=deer
사실=the truth, a fact
사실상=actually, in truth
사십=40
사업=business
사업가=businessman
사업자=businessman
사용=use, imply
사용되다=be used, be employed
사용자=a user, consumer, employer
사용하다=to use
사원=company employee
사월=April
사위=environment, surroundings
사이=space between 2 points; the relationship between 2 people
사이사이=every now and then
사이좋다=be on good terms with
사자=a lion
사장=company boss
사전=beforehand, in advance
사정=circumstances
사진=picture
사진기=camera
사촌=a cousin
사춘기=adolescence, puberty
사탕=sugar
사투리=a dialect
사표=a written resignation
사회=culture, society
사회생활=social life
사회자=president
사회적=socially
사회주의=socialism
사회학=social science
사흘=three days
산=a mountain
산길=a mountain path, road
산부인과=obstetrics and gynecology
산소=oxygen
산속=the heart of a mountain
산업=industry
산책=a walk, stroll
살=years old
살다=to live
살리다=revive, bring around, restore to life
살림=living, livelihood
살아가다=lead a life, get along
살아나다=revive, be brought back to life
살아남다=survive
살아오다=to come out alive
살인=murder
살짝=softly, lightly, just a little
살펴보다=watch closely
살피다=take a good look at
삶=life
삶다=boil, cook
삼=three
삼가다=be discreet, take care of
삼계탕=chicken soup
삼국=three countries
삼다=make a thing of
삼십=30
삼월=march
삼촌=an uncle
삼키다=swallow
상=upper
상관=concern, relation
상관없다=to not be of concern
상관없이=without anything to do with
상금=prize money
상담=consultation
상당=proper, fit, suitable
상당수=plenty, a lot of
상당하다=be proper, suitable
상당히=fairly, considerably
상대=counterpart, companion, rival
상대방=conversation partner
상대성=relativity
상대적=relatively, correlatively
상대편=the other party
상류=the upper classes, upstream
상반기=the first, upper half
상상=imagination
상상력=imaginative powers
상상하다=imagine
상식=common sense
상업=commerce, trade
상인=merchant, trader
상자=a box, case
상점=a shop, store
상징적=symbolic, emblematic
상징하다=symbolize
상처=wound
상추=lettuce
상쾌하다=be refreshing
상태=condition, state
상표=trademark, brand
상품=product
상하다=damage, injure
상황=state of things
새=new
새기다=to sculpt, engrave
새끼=baby animal
새다=leak, escape from
새로=newly, anew
새로이=newly, afresh
새롭다=to be new, novel
새벽=dawn, daybreak
새소리=bird voice
새우=lobster, shrimp
새우다=sit up all night
새해=a new year
색=color
색깔=color
색다르다=be different, novel
색연필=colored pencil
샌드위치=sandwich
생=raw, uncooked
생각=thought
생각나다=to remember
생각되다=to come to think sth
생각하다=to think
생겨나다=to begin, germinate
생기=animation, life
생기다=arise, occur, happen
생명=life
생물=a living thing
생방송=a live broadcast
생산=production, birth
생산되다=to be produced
생산력=productive capacity
생산자=a producer
생산하다=to produce, make
생선=raw fish
생신=a birthday
생일=a birthday
생활=lifestyle, livelihood
생활비=cost of living
생활수준=the standard of living
생활용품=necessities for daily life
생활하다=to live, make a living
생활환경=life environment
샤워=shower
서구=western Europe
서너=about three, three or four
서늘하다=be cool, refreshing
서다=to stand
서두르다=to hurry up
서랍=a drawer
서로=mutually, one another
서류=documents, papers
서른=thirty
서명=signing, autographing
서명하다=to sign
서민=common people
서부=the western part
서비스=service
서서히=slowly, little by little
서양=the western countries
서양인=a westerner
서울=Seoul
서울역=Seoul train station
서적=books, publications
서점=a bookstore
서쪽=the west
서클=circle
서투르다=unskilled, clumsy
서툴다=poor, awkward
석=a seat, sitting place
석사=master
석유=petroleum
섞다=blend, mix
섞이다=to be mixed, blended
선=a line, a route
선거=an election
선명하다=to be clear, distinct
선물=a present, gift
선물하다=give a gift
선배=one's senior
선생=teacher
선생님=teacher
선수=an athlete
선언하다=declare, proclaim, announce
선원=a crew, a ship's company
선장=a captain
선전=propaganda
선정하다=select, choose
선진=seniority, advance
선진국=a developed country
선택=a choice
선택하다=to choose
선풍기=a fan
선호하다=to prefer
설거지=dishwashing
설날=new year's day
설득하다=persuasion
설렁탕=beef soup with rice
설립하다=found, establish
설명=explanation
설명되다=to be explained
설명하다=to explain
설문=questions like those on a questionnaire
설사=diarrhea
설악산=famous mountain
설치=establishment, institution
설치되다=to be established
설치하다=to found, establish, create
설탕=sugar
섬=an island
섭섭하다=be sorry, disappointed
섭씨=Celsius
성=a sexual gender
성격=personality ; character, nature
성경=the bible
성공=success, achievement
성공적=successfully
성공하다=to succeed
성당=a church
성립되다=to be concluded, formed
성립하다=to exist, to come into being
성명=a declaration, statement
성별=sex distinction
성숙하다=to ripen, to mature
성실하다=be ripe
성인=an adult
성장=growth
성장하다=to grow, be brought up
성적=a result, grade
성질=disposition
성함=your esteemed name
세=three
세계=world
세계관=a worldview
세계적=international
세금=tax
세기=century
세다=to be strong, mighty
세대=generation
세련되다=to be polished, refined
세로=length
세미나=seminar
세상=the world, society
세상에=in the world
세수=hand-washing
세우다=stand up, erect
세워지다=to become erected
세월=the times, things
세제=detergent, cleaning material
세탁=laundry
세탁기=washing machine
세탁소=laundromat
세트=set
섹시하다=to be sexy
센터=center
센티미터=centimeter
셈=an intention, design, purpose
셋=three
셋째=the third
소=a cow
소개=introduction
소개되다=to be introduced, presented
소개하다=to introduce, present
소규모=small scale
소극적=passivity, passiveness
소금=salt
소나기=a sudden rain shower
소나무=a pine tree
소녀=a young girl
소년=a boy
소득=an income, earnings
소리=a sound, noise
소리치다=to shout, yell
소망=desire, wish, hope
소매=a sleeve
소문=a rumor
소문나다=a rumor starts
소박하다=simple, naive, ingenuous
소비=consumption
소비자=a consumer
소비하다=consumption
소설=a novel, fiction story
소설가=novelist
소속=belong to, attached to
소수=a small number, a few
소스=sauce
소시지=sausage
소식=news, information
소아과=pediatrics
소요되다=be needed
소용=use, usefulness
소용없다=to be useless
소원=one's desire
소위=what is called for
소유=possession
소유자=possessor
소유하다=to possess, hold
소음=a noise, cacophony
소재=material, subject matter
소주=Korean sake
소중하다=to be important, valuable
소중히=seriously, with care
소지품=one's things
소질=temperament, character
소파=sofa
소포=a parcel, package
소풍=picnic
소프트웨어=software
소형=small size
소홀히=carelessly, indifferently, neglectfully
소화=digestion
소화하다=to digest
속=the inside
속담=a proverb, saying
속도=speed
속마음=inner heart, feeling
속삭이다=whisper
속상하다=be distressing
속옷=underwear
속이다=deceive, cheat
속하다=belong to, be affiliated with
손=the hand
손가락=a finger
손길=an outstretched hand
손녀=granddaughter
손님=customer
손등=the back of the hand
손목=the wrist
손바닥=the palm
손발=hand and foot; the limbs
손뼉=the flat of one's hand
손수=with one's own hands, personally
손수건=a handkerchief
손쉽다=be easy, simple
손실=loss
손자=grandson
손잡다=take a person by the hand
손잡이=a handle, knob
손질=handling, care
손질하다=handle with care
손톱=fingernail
손해=damage, injury
솔직하다=frankness, candidness
솔직히=frankly, candidly
솜=cotton
솜씨=skill, ability
솟다=rise, soar, tower above
송아지=a calf, baby cow
송이=a bunch, cluster
송편=rice cake steamed over pine needles
쇠=iron
쇠고기=beef
쇼=show
쇼핑=shopping
수=way, method
수건=handkerchief
수고=toil, labor, pains
수고하다=to work hard
수년=several years
수단=means, way
수도=the capital city, e.g. Seoul, of a country
수도권=the metropolitan area
수도꼭지=a faucet, tap
수돗물=tap water
수동적=passively
수리하다=repair, mending
수만=tens of thousands
수많다=many and many
수면=sleep, slumber
수명=life span
수박=watermelon
수백=hundreds
수상=the prime minister
수석=the top seat
수술=surgery
수시로=on demand, per the demand of the occasion ; all the time, at any time
수십=tens of sth
수업=school, teaching
수없이=be unable to do
수염=beard
수영=swimming
수영장=swimming pool
수요=demand, requirement
수요일=Wednesday
수입=importing sth
수입되다=to be imported
수입품=an imported product
수입하다=to import
수저=a spoon
수준=level
수집=collection
수집하다=to collect
수천=thousands
수출=exporting sth
수출하다=to export
수컷=a male of the species
수표=a check
수필=an essay
수학=mathematics
수행하다=accomplishment
수험생=a student preparing for an examination
수화기=telephone receiver
숙녀=a lady
숙소=one's address
숙이다=lower one's head
숙제=homework
순간=a moment, a second
순간적=momentary
순서=system, order, sequence
순수=purity, genuineness
순수하다=to be pure
순식간=a brief instant
순위=order, ranking
순진하다=to be naive, pure
순하다=be gentle, docile
숟가락=a spoon
술=alcohol
술병=a bottle of alcohol
술자리=a banquet
술잔=a glass for alcohol
술집=bar of some kind
숨=a breath
숨기다=to hide
숨다=to be in hiding, to hide oneself
숨지다=breathe one's last breath
숫자=a figure, number
숲=forest
쉬다=to relax, take a break
쉰=50
쉽다=to be easy
슈퍼마켓=supermarket
스님=a priest
스무=20
스물=twenty
스스로=on its own, of its own free will
스승=a teacher, master
스웨터=sweater
스위치=switch
스치다=graze past
스케이트=skate
스케줄=schedule
스키=ski
스키장=place to ski
스타=star
스타일=style
스튜디오=studio
스트레스=stress
스포츠=sports
슬그머니=furtively
슬쩍=secretly, on the sly, stealthily
슬퍼하다=sorrow, feel sad
슬프다=to be sad, sorrowful
슬픔=sorrow
습관=habit
습기=moisture, humidity
승객=passenger
승리=a victory
승리하다=to win
승부=a contest, match
승용차=a passenger car
승진=promotion, advancement
시=time
시각=point of view
시간=time
시계=clock, timekeeper, timepiece
시골=countryside
시금치=spinach
시기=an opportunity, chance
시끄럽다=to be noisy, boisterous
시나리오=scenario
시내=the city
시내버스=inner-city bus
시대=an age, period
시대적=of the times
시댁=one's husband's family
시도=an attempt, test
시도하다=to try, attempt
시들다=to wither, die, fade
시디롬=CD-ROMs
시리즈=series
시멘트=cement
시민=residents of a city
시부모=one's husband's parents
시선=one's line of vision
시설=establishment, institution
시스템=system
시아버지=one's husband's father
시야=visual field
시어머니=one's husband's mother
시외=outside the city
시외버스=inter-city bus
시원하다=be cool, refreshing
시월=October
시위=a demonstration
시인=a poet
시일=time, days
시작=the beginning
시작되다=to begin, start
시작하다=to start, begin
시장=market, fair
시절=season, time, occasion
시점=point in time
시중=in the city
시즌=season
시집=one's husband's home
시집가다=to take a husband
시청=city hall
시청률=popularity rating
시청자=TV audience member
시키다=to make
시합=a contest, match
시험=a test
식=form, style
식구=members of a family, your immediate family members
식기=an eating vessel
식다=to get cold, cool off
식당=restaurant
식량=food, provisions
식료품=articles for food
식물=food, provisions
식빵=bread
식사=a meal
식사하다=to eat a meal
식생활=dietary life
식욕=appetite, desire
식용유=food oil
식초=vinegar
식탁=dinner table
식품=groceries
식품점=grocery store
식히다=to cool, let cool.
신=god
신고=a statement, declaration
신고하다=to state, declare
신규=a new regulation, a new project, sth new on a big scale ; work being done anew
신기하다=to be marvelous, astounding
신념=belief, faith
신다=put on, wear
신라=one dynasty in ancient Korea
신랑=a bridegroom
신문=a newspaper
신문사=newspaper company
신문지=newspaper paper
신발=shoes, footwear
신부=bride
신분=social position
신비=mystery
신사=a gentleman
신선하다=fresh
신설=a new theory
신세=indebtedness, obligation
신세대=the new generation
신속하다=be quick, rapid, speedy
신용=confidence, trust
신인=a new man
신입생=a new student
신제품=a new product
신중하다=to be prudent, cautious
신청=application, request
신청서=application, application form
신청하다=to apply
신체=the body
신체적=physical
신호=a signal, signaling
신호등=signal light, blinker
신혼부부=newlyweds
신혼여행=the honeymoon
신화=a myth
싣다=to load, take passengers
실=thread
실감=actual feeling
실내=in the room
실력=one's real ability, talent
실례=rudeness, impolite
실례하다=to be impolite
실로=really, indeed
실리다=to be printed, recorded; to be loaded onto a truck
실망=disappointment
실망하다=to disappoint
실수=a mistake
실수하다=to make a mistake
실습=actual training, practice
실시=execution, enforcement
실시되다=to be enforced
실시하다=to enforce, put into effect
실은=in reality, to tell the truth
실장=boss, president
실정=the actual situation
실제=the truth, a fact
실제로=in reality
실질적=substantial, essential
실천=practice
실천하다=to practice, put in theory
실체=substance, essence
실컷=to one's satisfaction
실태=the actual conditions, reality
실패=failure
실패하다=to fail
실험=an experiment, test
실현=realization, materialization
실현되다=to realize, bring to fruition
실현하다=to realize, bring to fruition
싫다=to not like, to hate
싫어지다=to become distasteful
싫어하다=to dislike, be reluctant
심각하다=seriousness, gravity
심각해지다=to become serious
심다=plant, sow
심리=a mental state
심리적=psychological
심부름=errand
심사=judgment, examination
심심하다=to be bored
심장=the heart
심정=one's heart, one's feelings
심판=referencing
심하다=to be extreme, intense
심해지다=become deep and serious
십=10
십이월=December
십일월=November
싱겁다=taste flat, have no flavor
싱싱하다=be fresh, full of life
싶다=want, hope
싶어지다=to come to want
싸구려=cheap, inferior
싸다=wrap in, bundle
싸우다=to fight
싸움=a fight
싹=a bud, sprout
싼값=a low price
쌀=uncooked rice
쌍=a pair, couple
쌍둥이=twins
쌓다=to pile up
쌓이다=be piled up
썩=very much, greatly
썩다=go bad, rot
썰다=chip, mince, dice
썰렁하다=chilly, feel cold
쏘다=to shoot
쏟다=to pour
쏟아지다=to pour out
쓰다=to write
쓰다듬다=stroke one's beard
쓰러지다=fall, collapse
쓰레기=garbage
쓰레기통=garbage can
쓰이다=to be used, to be utilized
쓴맛=see 6000
쓸다=brush, sweep perhaps lightly
쓸데없다=to be useless
쓸데없이=to have no use
쓸쓸하다=be lonely, lonesome
씌우다=put a hat on somebody
씨=Mr.
씨름=wrestling
씨앗=seeds
씩씩하다=be brave, valiant
씹다=to chew
씻기다=to be carried away, washed away
씻다=to wash, cleanse
아=oh dear
아가씨=young lady
아기=baby, infant
아까=a little while ago
아깝다=regrettable, pitiful
아끼다=grudge, spare
아나운서=announcer
아내=wife
아냐=no, that's not the case
아뇨=no, nay
아니=no!
아니다=to not be
아니야=no, that's not the case
아니요=no, that's not the case
아니하다=to be not
아드님=your esteemed son
아들=son, baby
아래=the bottom, the lower part
아래쪽=the lower part, the bottom
아래층=lower floor
아랫사람=subordinate
아르바이트=part time
아름답다=to be beautiful
아마=probably
아마도=probably
아무=anybody, everybody
아무개=Mr. so-and-so
아무것=anything
아무래도=never on any account, no matter what
아무런=no sort of
아무렇지않다=to be indifferent, casually
아무리=however much
아무튼=in any case
아버님=father
아버지=father
아빠=dad
아쉬움=sense of missing
아쉽다=to miss, feel the loss of
아스팔트=asphalt
아시아=Asia
아아=oh-oh!
아예=from the very first, from the very beginning
아울러=and, both together
아유=good heavens!
아이=child
아이고=oh my god!
아이디어=idea
아이스크림=ice cream
아저씨=sir, calling an unknown male
아주=extremely
아주머니=an aunt, a respectable word for a married, older woman
아줌마=old or married lady
아직=still
아침=morning
아파트=apartment
아프다=to hurt
아프리카=Africa
아픔=pain
아하=dear me! goodness!
아홉=nine
아흔=ninety
악기=musical instrument
악몽=nightmare
악수=handshake
안=inside
안개=fog
안경=glasses
안과=ophthalmology
안기다=to be embraced by sb.
안내=guidance, conducting
안내하다=to lead the way
안녕=hello
안녕하다=to say hello
안녕히=peacefully
안다=to hold, embrace
안동=fish common in this city
안되다=must not, should not
안방=the inner room
안부=safety, welfare
안심하다=security, assuredness, relief
안전=safety
안전하다=to be safe
안정=stability
안정되다=to be stable
안주=appetizers for alcohol
안쪽=the inside, the inner part
안타깝다=to be heart-breaking
안팎=the interior and exterior, both sides
앉다=to sit down
앉히다=to place a person in a set
않다=to not be, to not do
알=an egg, spawn
알다=to know
알려지다=to become known
알루미늄=aluminum
알리다=to inform, tell a person
알맞다=to fit, be fitting, suitable
알아내다=to find out
알아듣다=to listen and comprehend
알아보다=to investigate, examine, search
알아주다=acknowledge, recognize, appreciate
알코올=alcohol
앓다=to be ill, sick with sth
암=cancer
암시=a hint, suggestion
암컷=a female, a she
압력=pressure, stress
앞=in front of, before
앞길=the road ahead, outlook
앞날=the days ahead
앞두다=have a distance ahead
앞뒤=before and behind
앞문=the front gate
앞바다=the offing sea
앞서=before, previously
앞서다=to go before, precede
앞세우다=make a person go
앞장서다=to be in the lead
앞쪽=the front, the fore part
애=a baby, or a slightly derogative word for person
애쓰다=make efforts to do sth
애인=a lover
애정=love for a person, affection
애초=the first, the beginning
액세서리=accessory
액수=a sum, an amount
앨범=album
야간=the night time
야구=baseball
야구장=baseball field
야단=uproar
야옹=mewing, meowing
야외=the fields, the outskirts
야채=vegetables
야하다=to be gaudy, garish
약=about, approximately
약간=somewhat
약국=pharmacy
약속=a promise
약속하다=to make a promise
약수=medicinal water, mineral water
약점=a weak point, a vulnerable point
약품=medicines, medical supplies
약하다=to be weak
약해지다=to become weak
약혼녀=a girl who is engaged
약혼자=a fiancé, an engaged person
얄밉다=be offensive, mean
얇다=to be thin
양=quantity, volume
양국=both countries
양념=spices and condiments
양력=the solar calendar
양말=a sock
양배추=cabbage
양보=concession, compromise
양보하다=to make a concession, recede
양복=western European style clothing
양상추=lettuce
양식=a mode, a style, an order, a modality
양심=conscience
양옆=on both sides
양주=foreign wine
양쪽=both sides
양파=an onion
얕다=to be shallow, superficial
얘=sonny, you there
얘기=story
얘기하다=to tell a story
어=oh, well, why
어기다=run counter to, go against
어깨=shoulder
어느=some, a certain
어느덧=before one knows it
어느새=in no time, quickly
어두워지다=become dark
어둠=darkness
어둡다=to be dark, dim, gloomy
어디=where?
어때=what do you think?
어떠하다=to be how
어떡하다=to take some measures, to manage somehow
어떤=what kind of, what sort of
어떻다=how, what… do you think of
어려움=difficulty, hardship
어려워지다=to become difficult
어렵다=to be hard, difficult
어른=a man, an adult
어리다=to be very young, juvenile
어리석다=juvenile, foolish
어린아이=a youngster, a child
어린애=a youngster, a child
어린이=a youngster, a child
어린이날=children's day
어머=oh my god!
어머니=mom
어머님=mother
어색하다=to be awkward, shy with words, speechless
어서=quickly
어울리다=to be becoming, suiting
어저께=yesterday
어제=yesterday
어젯밤=last night
어지럽다=to be dizzy
어째서=for what reason, why is that
어쨌든=in any case, anyhow
어쩌다=by chance, accident
어쩌다가=by chance, accident ; sometimes
어쩌면=how on earth, how the hell
어쩐지=somehow, in a strange way
어쩜=well, I guess that, is extremely
어찌=how, in what way, by what means
어찌나=extremely, quite, awfully
어찌하다=be subject to an attack of vertigo
억=one hundred million
억울하다=to be regrettable, disappointing
언니=older sister
언덕=a hill
언론=a speech, discussion
언어=language, speech
언제=when, at what time
언제나=every time, always
언젠가=one of these days, at some time in the future
얹다=put on, place, lay, set
얻다=get, obtain
얻어먹다=go about begging
얼굴=face
얼다=freeze, be frozen
얼른=fast, quickly, rapidly
얼리다=freeze, make ice
얼마=how many, how much
얼마간=some, somewhat
얼마나=how many, how much
얼음=ice
얼핏=at a momentary glance or intermittently appearing
엄격하다=to be strict, serious
엄마=mamma
엄숙하다=seriousness, solemnity ; being grave, serious
엄청나다=to be absurd, wild, terribly large
업다=to carry on one's back, to shoulder sth
업무=business, duty
업종=types of industry
업체=a business enterprise
없다=do not exist, absent
없애다=remove, get rid of, do away with
없어지다=to lose, get lost
없이=without
엇갈리다=cross, miss each other
엉덩이=the buttocks
엉뚱하다=be extraordinary, extravagant
엉망=a mess, in bad shape
엉터리=fake, sham
엊그제=the day before yesterday, a few days ago
엎드리다=prostrate oneself, lie on the ground
에너지=energy
에어컨=air conditioner
엔=yen
엔진=engine
엘리베이터=elevator
여=a woman, a girl
여가=leisure, spare time
여간=just, a little
여건=a postulate, a given condition
여겨지다=to look, appear, think of sth as
여고생=female high school student
여관=a hotel, an inn
여군=a woman soldier
여권=a passport
여기=a hobby
여기다=think, consider as
여기저기=here and there
여대생=female college student
여덟=eight
여동생=younger sister
여든=eighty
여러=many, various
여러분=you
여럿=many, many people
여론=public opinion, public sentiment towards sth
여름=summer, summertime
여름철=summertime
여보=spouse
여보세요=telephone hello
여섯=six
여성=female
여왕=queen
여우=fox
여유=reserve, surplus
여인=beauty, belle
여자=woman, female
여전하다=be unchanged, the same as before
여전히=as it used to be, as before ; still, persistently, even still
여직원=female employee
여쭈다=tell a superior, inform
여학생=female student
여행=trip
여행사=travel agency
여행하다=to travel
역=a part, a role
역사=history
역사가=historian
역사상=in history
역사적=historical
역사학=the study of history
역시=as expected, likewise
역할=a part, a role
연간=for a year
연결=connection, linking
연결되다=connect, attach
연결하다=connect, attach
연관=a connection, a grouping together, relationships
연구=research
연구소=a research institute
연구실=a laboratory
연구원=researcher
연구자=researcher
연구하다=to research, investigate
연극=drama, a play
연기=performance, acting
연기되다=to be put off, postponed
연기자=a performer, an actor
연기하다=to be put off, postponed
연두색=light green
연락=connection, communication
연락처=a way to make contact
연락하다=to contact, get in touch with
연령=age, years of age
연말=the end, close of the year
연상하다=association of ideas
연설=a public speech
연세=age, years of age
연속=continuity, succession
연습=practice, exercise
연습하다=to practice, exercise
연애=love, tender, passion
연예인=a performer, an entertainer
연인=a sweetheart
연장=extension, prolongation
연주=a musical performance
연출=production, presentation
연출하다=produce, present
연필=pencil
연하다=tender, soft, mild
연합=combination, federacy, union
연휴=consecutive holidays
열=heat
열기=heat, hot air
열다=open
열리다=open, be opened, be unlocked
열매=fruit
열쇠=lock
열심히=enthusiastically, with zeal
열정=passion
열중하다=enthusiasm, zeal
열차=train
열흘=ten days
엷다=be thin, light
염려=anxiety, worry
염려하다=to worry, be anxious about
엽서=a postcard
엿보다=wait for an opportunity
영=really, totally
영국=England
영남=the southeastern part of Korea
영상=an image, reflection
영양=nutrition
영어=the English language
영업=business, doing business
영역=territory
영웅=a hero, a great man
영원하다=to be eternal
영원히=forever
영하=below zero
영향=influence, consequences
영향력=influence, power to influence
영혼=a soul, a spirit
영화=a movie
영화관=movie theater
영화배우=movie actor
영화제=movie festival
옆=next to
옆구리=the side, the flank
옆방=the room next door
옆집=the house next door
예=example
예감=a presentiment, a premonition
예고하다=warn, give advance notice
예금=deposit money
예매하다=advance purchase
예방=prevention, protection
예방하다=to protect, prevent, fend off
예보=forecast, predict
예비=preparation, reserve
예쁘다=pretty, lovely
예산=an estimate, budget
예상=expectation, anticipation; forecast, preconception
예상되다=to expect, anticipate
예상하다=to expect, anticipate
예선=a preliminary match
예순=sixty
예술=art, an art
예술가=an artist
예술적=artistic
예습=preparation of lessons
예습하다=to prepare lessons, rehearse
예식장=a ceremony hall
예약=pre-engagement, reservation
예약하다=to book in advance, pledge
예외=an exception
예의=courtesy, politeness
예전=old days, former days
예절=propriety, decorum
예정=a program, schedule
예정되다=make a program, set a schedule
예측하다=to predict, forecast
예컨대=for example, such as
옛=old, ancient
옛날=ancient times, antiquity
옛날이야기=an old story
오=oh, ah!
오가다=come and go, keep going and coming
오늘=today
오늘날=these days, nowadays
오다=to come
오락=entertainment
오래=long, for a long time
오래간만=after a long time
오래도록=for long, a long while
오래되다=to last for a long time
오래전=since a long time before
오랜=for a long time
오랜만=after a long time
오랫동안=for a long time
오렌지=orange
오로지=only, solely, exclusively
오르내리다=go up and down, rise and fall
오르다=go up, climb, ascend
오른발=the right foot
오른손=the right hand
오른쪽=the right side
오리=duck
오븐=oven
오빠=older brother
오십=fifty
오염=contamination, pollution
오염되다=to be polluted, contaminated
오월=may
오이=cucumber
오전=morning
오직=only, merely, solely
오징어=cuttlefish, squid
오페라=an opera
오피스텔=office hotel
오해=misunderstanding
오후=the afternoon
오히려=rather, preferably
옥상=on the roof
옥수수=corn
온=all, whole, entire
온갖=all kinds, all sorts
온도=temperature
온돌=the Korean under-floor heating system
온라인=online
온몸=the whole body
온종일=all day long, the whole day
온통=wholly, entirely
올=this year
올가을=this fall
올라가다=to go up, ascend
올라서다=stand up
올라오다=come up
올라타다=board, get into
올려놓다=put a thing on a place
올려다보다=look up
올리다=raise, lift up
올림픽=Olympic
올바르다=be honest, straightforward
올여름=this summer
올해=this year
옮기다=move, transfer to
옳다=to be right, correct
옷=clothes
옷차림=dress, one's way of dressing
와=holy cow!
와이셔츠=a white dress shirt
와인=wine
완벽하다=perfect
완성=completion, accomplishment
완성되다=to be accomplished
완성하다=to accomplish, to end successfully
완전=perfection, completeness
완전하다=to be perfect and faultless
완전히=completely, perfectly
왕=king
왕비=queen
왕자=prince
왜=why?
왜냐하면=because
왠지=I don't know why, there is no reason for it
외=except, save for
외갓집=one's mother's maiden home
외과=surgery
외교=diplomacy
외교관=a diplomat
외국=a foreign country
외국어=a foreign language; sometimes, only means English
외국인=a foreigner, a foreign national
외다=to repeat back
외로움=loneliness
외롭다=to be lonely, lonesome
외면하다=outward appearance
외모=outward appearance
외부=the exterior, the outside
외삼촌=an uncle on one's mother's side
외아들=the only son
외우다=recite from memory
외제=of foreign manufacture
외출=going out, an outing
외출하다=to go out
외치다=to shout, scream
외침=a shout, a cry
외할머니=a maternal grandmother
외할아버지=a maternal grandfather
왼발=the right foot
왼손=the right hand
왼쪽=the left side
요=right near at hand
요구=a demand, claim, request
요구되다=to be requested, claimed
요구하다=to demand, claim, request
요금=a rate, a fare
요리=cooking
요리사=a chef, a cook
요리하다=to cook
요새=recently, lately
요약하다=summary, condense, abridge
요일=a day of the week not the weekend
요즈음=recently, nowadays
요즘=recently, nowadays
요청=request, demand, claim
요청하다=to ask for, to request
욕=an insult
욕실=a bathroom, a bath
욕심=greed, selfishness
욕하다=to insult, to say bad words
용=a dragon
용감하다=to be brave, courageous
용기=bravery
용도=use, service
용돈=pocket money, money for expenses
용서=pardon, forgiveness
용서하다=to pardon, to forgive
용어=technical terminology
우려=worry, anxiety, fear
우리=we, our
우리나라=Korea
우리말=Korean
우산=an umbrella
우선=first of all, before everything
우수하다=to be superior, excellent
우습다=to be funny, amusing
우승=first place
우승하다=to take first place
우아하다=to be elegant, refined
우연히=accidentally, by chance
우울하다=to be melancholy, gloomy
우유=milk
우정=feeling of friendship
우주=the universe
우체국=a post office
우편=post, mail
우표=a postage stamp
운=fortune, luck, fate
운동=motion, movement
운동복=exercise clothes
운동장=stadium, playground
운동하다=to do exercise
운동화=sports shoes
운명=fate, fortune
운반=conveyance, transport
운영하다=manage, administer
운전=driving
운전기사=the driver
운전사=the driver
운전자=the driver
운전하다=to drive
운행=movement, revolution
울다=to cry, weep
울리다=to ring a bell; to create an echo effect
울음=crying, weeping
울음소리=sound of crying
움직이다=to move, stir
움직임=movement, motion, activity
웃기다=to be funny
웃다=to laugh, smile
웃어른=one's elders
웃음=laughter, a smile
웃음소리=the sound of laughing
워낙=by nature, primarily, by constitution
원=a unit of south Korean money
원고=a manuscript
원래=originally, primarily
원서=an application, a written request
원숭이=a monkey
원인=a cause, a factor
원장=the chief
원피스=a dress
원하다=to want
월=a month
월급=monthly salary
월드컵=world cup
월세=monthly rent
월요일=Monday
웨이터=waiter
웬=what sort of, what kind of
웬만하다=to be just only barely passable, fairly good
웬일=what cause, what reason
위=the upper part, above
위기=a crisis, an emergency situation
위대하다=to be great, mighty, grand
위로=consolation, solace
위로하다=to console, soothe somebody
위반=violation, infringement
위반하다=to violate
위법=illegality, a breach of the law
위성=a satellite
위아래=up and down
위원=a member of a committee
위원장=a chairman of a committee
위주=put first in importance
위쪽=the upper direction
위층=the upper floor
위치=a position, a location
위치하다=to be located
위하다=to do for the sake of
위험=danger
위험성=riskiness
위험하다=to be dangerous
위협=menace, threat, intimidation
윗몸=the upper body
윗사람=a superior, one's older somebody
유교=Confucianism
유난히=uncommon, exceptional
유능하다=to be competent, talented
유럽=Europe
유리=a glass pane
유리창=a window which uses glass
유리하다=to be profitable, favorable
유머=humor
유명=fame, celebrity status
유명하다=to be famous
유물=a relic, cultural remains
유발하다=to induce, bring about, cause
유사하다=to be similar, to resemble
유산=an inheritance, property left behind
유월=June
유의하다=to bear in mind, be heedful of
유적=remains, relics, ruins
유적지=place where remains
유지되다=to be maintained, preserved
유지하다=to preserve, maintain
유치원=kindergarten
유학=studying abroad
유학생=a foreign student
유행=fashion, vogue
유행하다=to be in fashion, to be popular
유형=a similar type
육=the number six
육군=the army
육상=on land, on the ground
육십=sixty
육체=the flesh, the body
육체적=corporeal, of the flesh
으레=customarily, habitually
으응=ugh!
은=silver
은은하다=to be distant, faint, indistinct
은행=a bank
음=sound you make to express doubt, worry
음력=the lunar calendar
음료=a beverage, a drink
음료수=drinking water
음반=a phonograph record
음성=a voice
음식=food
음식물=anything to eat or drink
음식점=restaurant
음악=music
음악가=a musician
음주=drinking
응=yes, I see!
응답하다=an answer, a reply
의견=an opinion, a suggestion
의논=consultation, conference
의논하다=to consult, confer with, talk over a matter
의도=an intention, an aim
의도적=purposefully
의류=clothes, dresses; clothing
의무=a duty, an obligation
의문=a question, a doubt
의미=a meaning, a sense
의미하다=to mean, signify
의복=clothes, garments
의사=a doctor, a physician
의식=a ceremony
의식하다=be conscious of, be aware of
의심=a doubt
의심하다=to be suspicious, to doubt
의외로=unexpectedly, surprisingly
의욕=volition, will, desire
의원=a member
의자=a chair
의존하다=to depend on, rely on
의지=will, volition
의지하다=to look to, depend on, rely on
의하다=to be due to, owing to
의학=medical science
이=a person, a man, a woman
이같이=like this, like so
이거=this thing
이것=this thing
이것저것=this and that, one thing and another
이곳=this place, here
이곳저곳=everywhere
이기다=to win
이끌다=to guide, lead
이날=today, this day
이내=soon, right away
이념=an idea, a doctrine, ideology
이놈=that rascal!
이다음=next
이달=this month
이대로=as it is
이데올로기=ideology
이동=movement, migration, drift
이동하다=to move, migrate, travel
이따가=a little later
이따금=from time to time
이때=at this time, moment
이래=since, after that, hereafter
이래서=this way, this direction, here
이러다=do think this way
이러하다=be this way, be like follows
이런=such, like this
이런저런=this and that, one and another
이렇게=in this way
이렇다=like this
이력서=curriculum vitae, a resume
이론적=theoretical
이롭다=be good for
이루다=accomplish, complete
이루어지다=get accomplished, achieved
이룩하다=erect, build
이뤄지다=to make something for a specific purpose
이르다=to reach, arrive, get at
이름=name
이리=this way, this direction
이리저리=this way and that, here and there
이마=forehead
이모=a maternal aunt
이미=already
이미지=image
이민=emigration
이발소=barber's shop
이번=this time
이별=parting, separation; divorce
이분=divide into two
이불=bedding, bed clothes
이빨=a tooth
이사=house-moving
이사장=a director
이사하다=to move house
이상=more than, above
이상적=abnormal
이상하다=to be strange, queer
이성=reason, reasoning
이슬=dew, dewdrops
이십=twenty
이야기=conversation, talk
이야기하다=to talk
이어=vulgarity, slang
이어서=subsequently
이어지다=get joined, be connected
이외=except, apart from
이용=to use
이용되다=to be used
이용자=a user; visitor
이용하다=to use, make use of
이웃=the neighborhood
이웃집=the neighbor's house
이월=February
이유=reason
이윽고=after a while, shortly
이익=profit
이자=interest
이전=former days
이제=now
이제야=these days
이중=duplication, double
이쪽=this side, our way
이튿날=the second day after
이틀=two days
이하=less than, below
이해=understanding
이해관계=mutual understanding
이해되다=to be understood
이해하다=to understand
이혼=divorce
이혼하다=to get divorced
이후=after that
익다=ripe, be ripe
익숙하다=to become accustomed to
익숙해지다=to become accustomed to
익히다=habituate oneself to
인=a person
인간=a person, a human being
인간관계=human relations
인간성=human nature
인간적=personal
인격=personality, character
인공=art, human skill
인구=population
인근=the neighborhood
인기=popularity
인도=pavement, sidewalk
인류=the human race
인물=a man, a person
인분=how many people counter for at restaurants
인사=greetings
인사말=words of greeting
인사하다=to greet, say hello
인삼=ginseng
인삼차=ginseng tea
인상=pulling up
인상적=impressive
인생=life
인쇄=printing, typography
인식하다=recognition, cognizance
인연=cause and occasion
인원=the number of persons
인재=a man of ability
인정되다=to be recognized
인정받다=to receive recognition
인정하다=to acknowledge, authorize
인제=now
인종=a human race
인천=Incheon city
인천공항=Incheon international airport
인체=the human body
인터넷=internet
인터뷰=interview
인하=reduction, lowering
인하다=to be due to, caused by
인형=a doll
일=work
일곱=seven
일기=a diary, journal
일단=temporarily
일대=one great
일등=first class, first class
일반=universal, common, usual
일반인=of the general public
일반적=universal, general
일본=Japan
일본어=Japanese
일부=a part, a portion
일부러=on purpose, intentionally
일상=everyday, usual, ordinary
일상생활=everyday life
일상적=daily, of the everyday things
일생=one's lifetime
일손=work in hand
일시적=of a day
일식=Japanese food
일쑤=habitual practice
일어나다=to rise, get up
일어서다=to rise to one's feet, stand up
일요일=Sunday
일월=January
일으키다=raise, get up; start, commence
일일이=one by one, individually
일자=a date, the number of days
일자리=a job, position
일정=to be fixed, settled, regular
일정하다=to be regular, established, uniform ; changeless
일종=a kind, a sort, a species
일주일=one whole day
일찍=early
일찍이=early
일체=all, everything, the whole
일치=agreement, accord
일치하다=agree with, to be in accord with
일하다=to work, labor
일행=a party, a troupe; a row, a line
일회용=for one time use
일회용품=a product to be used only once
일흔=seventy
읽다=to read
읽히다=to get a person to read, to get a person to learn
잃다=to lose, to miss, to be deprived
잃어버리다=to lose
임금=wages, pay
임무=a duty, an office, a task
임시=temporary, special
임신=pregnant
임신부=an expectant mother
임신하다=to be pregnant
입=mouth
입구=entrance
입국=entering a country
입다=to wear
입대=enlistment, enrollment
입력=power input
입력하다=to input
입맛=appetite, taste, palate
입사=enter a company
입사하다=to join a company
입술=the lips
입시=an entrance examination
입원=hospitalization
입원하다=to enter a hospital
입장=a position, situation
입학=admission into school
입학하다=to be admitted into a school
입히다=clothe, dress
잇다=join, connect
잇따르다=follow one after another
있다=to be
잊다=to forget
잊어버리다=to forget
잊혀지다=to become forgotten
잎=a leaf
자=a person
자가용=for personal use
자격=qualification
자격증=a qualification certificate
자극=a stimulus
자극하다=to stimulate
자기=oneself, number one
자꾸=constantly, repeatedly
자꾸만=repeatedly
자네=you
자녀=one's children
자다=to sleep
자동=self-acting, self-moving, automatic
자동차=car
자라나다=to grow up
자라다=to grow up
자랑=pride
자랑스럽다=to be proud
자랑하다=to be proud
자료=materials, data
자르다=cut, chop
자리=seat, spot
자매=sisters
자부심=pride
자살=suicide
자살하다=commit suicide
자세=position, posture
자세하다=be detailed
자세히=in detail
자식=one's children
자신=one's own self, one's own body
자신감=self-confidence
자연=nature
자연스럽다=to be natural
자연적=natural
자연현상=natural phenomena
자연환경=natural surroundings
자연히=naturally
자원=resources
자유=freedom
자유롭다=to be free
자율=self-control, autonomy
자장면=black Chinese noodles
자전거=bicycle
자정=midnight
자존심=self-confidence
자주=always, constantly
자체=one's own body
자취=a trace, vestige
자판=keyboard
자판기=vending machine
작가=writer, author
작년=last year
작다=small
작성=editing, composition ; filling out a form
작성하다=to edit or compose, write up ; to fill out a form
작아지다=become smaller
작업=work
작용=application
작용하다=to apply , use
작은딸=younger daughter
작은아들=younger son
작은아버지=an uncle younger than your father
작은어머니=an aunt younger than your mother
작품=a work of art
잔=a cup, wine glass
잔디=lawn
잔디밭=lawn, grass
잔뜩=extremely, to the utmost
잔치=banquet, feast
잘=well
잘나다=to be handsome, excellent
잘되다=to turn out well
잘리다=be snapped, broken, cut off
잘못=wrong, mistake
잘못되다=to turn out wrong
잘못하다=to make a mistake
잘살다=to be affluent, well-off
잘생기다=to be handsome
잘하다=to do well
잠=sleep
잠그다=to lock
잠기다=sink in water
잠깐=for a little while
잠들다=fall asleep
잠바=jumper
잠수함=submarine
잠시=for a little while
잠옷=pajamas
잠자다=fall asleep
잠자리=bed
잡다=seize, catch
잡수다=eat, drink
잡수시다=eat, drink
잡아당기다=pull
잡아먹다=slaughter and eat
잡지=a magazine
잡히다=to be caught ; to extinguish a fire
장=one piece of sth flat
장가=to get married
장갑=a pair of gloves
장관=a government cabinet minister
장군=a general
장기간=for a long period
장기적=long-term
장난=a game, playing
장난감=a toy
장남=the eldest son
장래=the future
장례=a funeral
장례식=a funeral
장르=genre
장마=the rainy spell in the summer
장면=a scene, situation
장모=a man's mother in law
장모님=a man's mother in law
장미=a rose
장비=equipment, fittings
장사=trade, business
장사꾼=a trader, merchant, dealer
장소=place
장수=a tradesman, merchant
장식=decoration
장애인=a handicapped person
장인=a man's father in law, the wife's father
장점=a merit, strong point
장차=in the future, someday
장학금=scholarship
잦다=be frequent, incessant
재능=talent, ability
재다=measure
재료=stuff, material
재미=amusement, enjoyment
재미없다=boring
재미있다=interesting, fun
재밌다=interesting, fun
재빨리=quickly, rapidly
재산=property, fortune, assets, possessions
재생=revival, restoration to life
재수=luck, fortune
재우다=put to sleep
재작년=the year before last
재정=finances, economy
재주=ability, talent
재즈=jazz
재채기=sneeze, sneezing
재판=a trial
재학=to be in school, be attending school
재활용=recycling
재활용품=a recycled product
쟤=that kid
저=that
저거=that thing over there
저것=that thing over there
저고리=a coat, Korean jacket
저곳=that place over there
저기=that place, there
저녁=evening
저녁때=evening time
저러다=like that
저런=such a, that sort of
저렇게=like that
저렇다=such a thing as that
저리=that place
저마다=each one, everyone
저번=last time, the other day
저울=a balance
저자=a writer, author
저절로=of itself, on its own accord
저지르다=do, commit, spoil
저쪽=over there, in that direction
저축=savings, saving
저편=that side, direction
저희=we
적=the time, the occasion, when
적극=the positive
적극적=positively
적다=to be small, few in number
적당하다=to be appropriate
적당히=suitable, proper
적성=aptitude
적어도=at the least
적어지다=to become smaller
적용=application
적용되다=to be applied
적용하다=to apply
적응=adaptation
적응하다=be suited to, adapted to
적절하다=appropriateness
적합하다=suitability, fitness
적히다=to be recorded, written down
전=before
전개=unfolding, development, expansion
전개되다=to be unfolded, spread out
전개하다=to unfold, evolve, spread out
전공=specialty
전공하다=to major in something
전구=an electric bulb
전국=the whole country
전국적=national
전기=electricity
전기밥솥=electric rice cooker
전날=the day before, the day prior
전달=delivery
전달되다=to be delivered
전달하다=to deliver
전라도=south-western region of south Korea
전망=a view, prospect
전망하다=have a view of, observe
전문=a specialty
전문가=a specialist
전문적=of a specialist nature
전문점=exclusive store
전문직=specialty job
전반=the whole, all, general
전반적=over-all, all
전부=all, everything
전선=the battle line
전설=a tradition, a legend
전세=renting with a big down payment and not paying month to month
전시=exhibition, display
전시되다=to be exhibited, displayed
전시장=an exhibition hall
전시하다=to display
전시회=an exhibition, show, display
전용=exclusive or private use
전자=an electron
전쟁=war
전철=an electric railway
전체=the whole, the entire section
전체적=entirely, generally
전통=tradition, convention
전통문화=traditional culture
전통적=traditional
전하다=to transmit, convey
전해지다=to be transmitted
전혀=entirely, utterly, completely
전화=telephone
전화기=telephone receiver
전화번호=telephone number
전화하다=to call
전환=to exchange, convert, change
전환하다=to exchange, to convert, to change over
전후=sequence, order, front and rear
절=a Buddhist temple
절대=absoluteness
절대로=absolutely
절대적=absolute, unconditional
절망=despair, hopelessness
절반=half
절약=thrift, savings, economy
절약하다=to economize
절차=process, formalities
젊다=to be young, youthful
젊은이=young person
젊음=youth
점=store
점검=inspection, examination
점수=marks, the number of marks
점심=lunch
점심때=lunchtime
점심시간=lunchtime
점원=a shop-assistant
점잖다=to be dignified, well-bred
점점=more and more, by degrees
점차=gradually, in steps
접근=proximity
접근하다=approach, get near
접다=fold up
접시=a plate, platter
접촉=contact, touch
접하다=adjoin, be adjacent to
젓가락=a pair of chopsticks
젓다=to make a sign, gesticulate
정=feeling of attachment
정거장=a railroad station
정기=a fixed time period
정기적=fixed, regular
정답=the right answer
정당=a political party
정도=grade, degree
정류장=stop, a station, bus-stop
정리=arrangement, regulation, adjustment
정리되다=to be adjusted
정리하다=to adjust
정말=really
정말로=really
정면=the front, the facade
정문=the front gate, main entrance
정반대=direct opposition, the exact reverse
정보=information, intelligence
정보화=change to an information orientation
정부=government
정비=maintaining equipment in good working order
정상=the top, summit
정상적=normal, like usual
정성=true heart, devotion
정식=formality, due form
정신=mind, spirit
정신과=psychiatry
정신없이=feel distracted and scatter-brained
정신적=mental
정오=noon
정원=garden
정장=full dress, uniform
정지=stop, an interruption
정직하다=honesty, uprightness
정치=politics
정치권=political rights
정치인=politician
정치적=political
정치학=political science
정하다=to set, determine
정해지다=to be determined, settled
정확하다=to be exact
정확히=exactly
젖=the breasts
젖다=to be wet, soaked
제거하다=exclusion, removal
제공=an offer
제공하다=offer, proffer
제과점=confectionary store
제대로=as properly is suitable
제대하다=be discharged from the military
제도적=systematic
제목=a subject, theme
제발=kindly, please
제법=quite, fairly, considerably
제비=a swallow
제사=a holiday ceremony
제삿날=day of the ceremony
제시=presentation
제시되다=to be presented
제시하다=to present
제안=a proposal, suggestion
제안하다=to propose, make a suggestion
제약=a condition, restriction
제외되다=to be excluded
제외하다=to exclude
제의=a proposal, an offer
제의하다=make a suggestion
제일=the first
제자=a disciple
제자리=the proper place
제작=manufacture, production
제작하다=to produce, manufacture
제주도=tourist island off south Korea
제출=presentation, submission
제출하다=to submit, tender
제품=manufactured goods
제한=limits, bounds
제한되다=to be restricted, limited
제한하다=to restrict, limit
조=article, clause
조각=sculpture
조개=shellfish, clam
조건=condition, stipulation
조그마하다=be tiny, small
조그맣다=be tiny, small
조금=a little
조금씩=a little at a time, little by little
조기=an early stage, period
조깅=jogging
조르다=to tease, urge sb.
조명=lighting, illumination
조미료=seasoning, condiment
조사=investigation, inquiry
조사하다=to examine, investigate
조상=ancestors
조선=name for ancient Korea culture
조심스럽다=cautious
조심하다=to be careful
조용하다=to be quiet, still
조용히=quietly
조절=regulation, adjustment
조절하다=to regulate, tune
조정=regulation, control, coordination
조정하다=to regulate, adjust, coordinate
조직=organization
조카=nephew
조화되다=harmony, agreement
존경하다=respect
존댓말=respectful speech
존재=existence
존재하다=to exist
존중하다=appreciate, esteem, value
졸다=doze, take a nap
졸리다=feel sleepy, drowsy
졸업=graduation
졸업생=a graduate
졸업하다=to graduate
졸음=sleepiness, drowsiness
좀=a little
좁다=narrow
좁히다=make narrow, restrict
종=a sort, kind, species
종교=religion, a faith
종교적=of religions
종로=famous street in Seoul
종류=kind, sort, species
종소리=the sound of a bell
종업원=waiter
종이=paper
종이컵=a paper cup
종일=all day, throughout the whole day
종종=a variety of things
종합=synthesis
종합하다=synthesize, integrate
좋다=to be good
좋아=that's good
좋아지다=to become better
좋아하다=to like, be fond of
좌석=a seat
좌우=left and right
죄=a crime, a sin
죄송하다=regret, be sorry for
죄인=a criminal
주=one week
주거=residing, dwelling
주고받다=give and receive, exchange
주관적=subjective
주년=one whole year
주다=to give, to do for a person
주로=principally, mainly
주름=wrinkles
주름살=wrinkles
주말=weekend
주머니=pocket
주먹=fist
주무시다=to sleep
주문=an order, a request
주문하다=to order, to request
주민=inhabitants, dwellers
주방=a kitchen, a cook room
주변=a circumference
주부=a wife
주사=a shot, an injection
주소=an address
주스=juice
주식=stock
주어지다=to offer, proffer
주요=the major, the chief thing
주요하다=to be chief, principal, leading
주위=the circumference, the girth
주의=attention, notice
주의하다=pay attention to
주인=the head of a family, the owner
주인공=the head of a family, the hero
주일=a week
주장=assertion, insistence
주장하다=to assert, maintain
주저앉다=sit down, plump down
주전자=a kettle, teakettle
주제=subject, theme, topic
주차=parking
주차장=parking lot
주차하다=to park
주택=a house
주한=residing in Korea
죽=rice porridge
죽다=die, pass away
죽음=death
죽이다=to kill
준비=preparation
준비되다=to be ready
준비물=stuff that needs to be prepared
준비하다=to prepare
줄=way, method
줄거리=a stalk, a stem
줄곧=all the time, all through, repeatedly, constantly
줄기=a trunk, stem, stalk
줄다=diminish
줄무늬=a stripe
줄어들다=dwindle away
줄이다=reduce, decrease
줍다=pick up, gather
중=the center, the middle
중간=in the middle
중계방송=a relay, a hookup
중국=china
중국어=Chinese
중국집=Chinese restaurant
중년=middle-aged
중단=interruption, suspension
중단되다=to be suspended, stopped
중단하다=to interrupt, to stop
중대하다=importance, gravity
중독=poison
중반=at the middle stage
중부=the center, middle part
중세=the middle ages
중소기업=small and medium enterprises
중순=the second 10 days in a month
중식=Chinese food
중심=the nucleus, the focus, the heart
중심지=a central place
중앙=the middle and the heart
중얼거리다=mutter to oneself
중요=importance, consequence
중요성=importance, gravity
중요시하다=attach great importance to
중요하다=to be important, weighty
중학교=middle school
중학생=middle school student
쥐=mouse
쥐다=to hold, seize
즉=namely, that is to say
즉석=instantly, impromptu
즉시=at once, immediately
즐거움=pleasure, merriment
즐거워하다=to enjoy it
즐겁다=be pleasant, agreeable
즐기다=enjoy oneself, take pleasure, delight
증가=an increase, augmentation
증가하다=increase, rise, grow
증거=evidence, proof
증권=securities, document, deed
증권사=securities corporation
증명하다=to prove, show, bear
증상=symptoms
증세=symptoms, a patient's condition
지=since, from
지각=perception, consciousness
지갑=a purse, wallet
지겹다=to be tedious, tiring
지경=a boundary, situation, state
지구=the earth
지극히=very, extremely
지금=now
지금껏=so far, till now
지급=supply, pay
지급하다=to pay, allow, furnish sth
지나가다=to pass, elapse
지나다=pass, elapse, go on
지나치다=go too far, to go to extremes
지난날=old days, old times
지난달=last month
지난번=last time
지난주=last week
지난해=last year
지내다=to pass, spend time
지능=intelligence, intellect, raw intelligence
지니다=carry with, hold, possess
지다=carry
지대=zone, belt, district
지도=map, atlas
지도자=leader
지도하다=to lead, instruct
지루하다=be tedious
지르다=holler, yell, scream
지름길=a shortcut
지리산=chili mountain, very beautiful
지방=a locality, district
지배하다=control, direct
지불하다=to pay
지붕=a roof
지속되다=be lasting a long time, be continuous
지속적=continuous
지시=directions, orders
지시하다=to direct, instruct
지식=knowledge, information
지식인=an intellectual
지역=an area, region
지우개=an eraser
지우다=to erase
지워지다=to be erased
지원=helping, supporting, aiding
지원하다=to desire, aspire, hence to apply for
지위=position, status
지저분하다=be messy, soiled, dirty
지적=pointing out, indication
지적되다=to be pointed out to
지적하다=to indicate, point out
지점=a spot, point
지지=support, backing
지진=earthquake
지출=expenses, expenditure
지치다=be exhausted, fatigued
지켜보다=watch, stare at
지키다=protect, maintain
지폐=paper money
지하=underground
지하도=underground road
지하철=subway
지혜=wisdom, wits
직선=a straight line
직업=an occupation, calling
직원=staff
직장=one's work place
직장인=a worker
직전=just immediately before
직접=directly
직접적=directly, immediately
직후=immediately after
진급=promotion
진단=diagnosis
진단하다=to diagnose
진달래=azalea
진동=vibration, shake
진로=a course, direction, path
진료=medical examination and treatment
진리=a truth, a fact
진실=truth, sincerity
진실로=truly, honestly
진실하다=be true, truthful
진심=the whole heart, sincerity
진지하다=to be serious, earnest
진짜=real
진찰=a medical diagnosis, investigation
진출=an advance
진출하다=penetrate into, advance
진통=labor pains, travail
진하다=be dark, deep
진행=progress, advance
진행되다=to have progressed, be advanced
진행자=leader of the performance
진행하다=advance, proceed
질=quality, character
질문=a question, a query
질문하다=ask a person a question
질병=a disease, sickness
질서=order, system
질적=qualitative
짐=luggage ; what is on a person
짐작=guess, conjecture
짐작하다=to guess, infer
집=house
집다=pick up
집단=a group, a collective body
집단적=collectively
집안=inside the house
집안일=housework
집어넣다=put in
집중=concentration
집중되다=to concentrate
집중적=related to the concentration
집중하다=to concentrate
짓=something you do
짓다=to make, build ; to form a line
짙다=be dark, dense
짚다=feel, examine
짜다=form, organize
짜증=annoyance
짜증스럽다=to be annoying
짝=one pair, one couple
짧다=short, brief
짧아지다=to become short
쩔쩔매다=to be at a loss, be confused
쪽=way, direction
쫓겨나다=chase away ; to fire from your job
쫓기다=to be chased, be driven
쫓다=drive away, chase off
쭉=all the time
찌개=a pot stew
찌꺼기=drugs, sediments, remnants
찌다=chop, hack
찌르다=stab, thrust
찍다=stamp with
찍히다=get sealed, stamped
찢다=tear, rend, split
찢어지다=to be torn, rent
차=a vehicle, train, auto car
차갑다=cold
차남=one's second eldest son
차다=to be full, to be filled with
차라리=rather, preferably
차량=vehicles, cars
차례=order, precedence, one round
차리다=make ready, prepare
차림=appearance of clothes or worn objects
차마=for all the world
차별=distinction, differentiation
차선=a traffic lane
차이=difference, disparity
차이점=a point of difference
차차=gradually
차창=car window
차츰=gradually, step by step
착각=hallucination, illusion
착각하다=to misunderstand, to deceive oneself
착하다=to be nice
찬물=cold water
찬성=approval, assent
찬성하다=to approve, support
참=really, truly
참가=participation, joining
참가하다=to take part in, join
참고하다=to refer, consult
참기름=sesame oil
참다=bear, endure
참되다=to be true, honest, faithful
참새=a sparrow
참석=attendance, participation
참석자=persons present
참석하다=to attend, take part in
참여=participation
참여하다=to participate in, take part in
참외=a melon
참으로=really, indeed
참조=reference, comparison
찻잔=a teacup
창=window
창가=next to a window, or, the window's edge
창고=a warehouse, storehouse
창구=a window
창문=a window
창밖=outside the window
창작=creation, origination
창조=creation
창조적=creatively
창조하다=create
창피하다=to be ashamed
찾다=seek, look for
찾아가다=to go to a place to meet somebody
찾아내다=to find out, discover
찾아다니다=to go around to meet somebody or see places
찾아보다=to go meet somebody
찾아오다=to go meet somebody, to go get sth
채=as it is, no change
채널=channel
채소=vegetables, greens
채우다=to fill up, complete, fulfill
채점=marking, grading, scoring
책=a book
책가방=book bag
책방=reading room
책상=on the desk
책임=responsibility
책임감=feeling of responsibility
책임자=person responsible
책임지다=take responsibility
챔피언=champion
챙기다=gather, collect
처녀=a virgin, a young maiden
처리=handling, treatment
처벌=punishment, penalty
처음=first
처지=a situation, circumstances
척=a few ships
척하다=the preceding verb is a lie
천=cloth, woven stuff
천국=heaven
천둥=thunder
천장=the ceiling
천재=genius, talent
천천히=slowly
철=steel
철도=railroad
철저하다=thoroughness, cleanliness
철저히=thoroughly
철학=philosophy
철학자=philosopher
철학적=philosophical
첫=first
첫날=the first day
첫째=the first
청년=a young man, a youth
청바지=blue jeans
청소=cleaning
청소기=a vacuum cleaner
청소년=young boys and girls, teenagers
청소하다=to clean
청춘=youth, the springtime of life
청하다=ask, request
체계적=systematic, organizational
체력=physical strength
체온=body temperature
체육=physical education
체육관=gymnasium
체조=gymnastics
체중=body weight
체하다=pretend, feign
체험=an experience
체험하다=to experience, to undergo
쳐다보다=to look up at
초=initial, in the beginning, first
초기=the early days, the initial period
초대=an invitation
초등학교=elementary school
초등학생=an elementary school student
초록색=green
초반=the opening part
초밥=Japanese vinegar rice vegetables
초보=initial, first steps
초보자=a beginner, neophyte
초상화=a portrait, a picture
초순=the first third of a month
초여름=early summer
초원=a plain, a prairie
초저녁=early in the evening
초점=a focus, a focal point
초조하다=be impatient, irritated
초청=an invitation
초청장=an invitation
초청하다=to invite
초콜릿=chocolate
촌스럽다=unfashionable
촛불=candle-light
총=all, entire, whole
총각=a bachelor, an unmarried man
총리=general overseeing, presiding over
총장=the president, the chancellor
촬영=photographing, taking pictures
최고=the best
최고급=the highest grade
최근=recently
최대=the greatest, the largest
최대한=at the most, at the maximum
최상=the best, the finest
최선=the best, one's best
최소=at the least, the minimum
최소한=at least
최신=newest, the latest
최악=the worst
최저=the lowest, the minimum price
최종=last, final, terminal
최초=in the very first, in the beginning
최후=the last, the end, the conclusion
추가=an addition
추가되다=to be added
추가하다=to add sth, to supplement
추다=to dance
추석=Korean thanksgiving
추억=memory
추위=cold
추진=propulsion, drive
추진하다=to propel, drive forward
추천=a recommendation
추천하다=to recommend, say a good word for
추측=guess, conjecture
축구=football
축구공=a soccer ball
축구장=soccer field
축소=reduction, a cutback
축제=a festival
축하=congratulation, celebration
축하하다=to congratulate sb.
출구=an exit
출국=leaving a country
출근=going to work
출근하다=to go to work
출발=to start
출발점=the starting point of a trip
출발하다=to depart, leave
출산=child birth
출석하다=attendance, presence
출신=a native, place one is from
출연=going on stage
출연하다=appear on stage, act, sing
출입=coming and going
출입국=entry into a country
출입문=door for exiting and entering
출장=a business trip
출퇴근=go to and come from the office
출판=publication, publishing
출판사=a publishing company
출현하다=appearance, turning out
춤=dance
춤추다=to dance
춥다=to be cold
충격=an impact, a shock
충격적=shocking
충고=advice, counsel, suggestion
충돌=a collision, clash; discord
충돌하다=collide, clash with
충분하다=to be sufficient, ample
충분히=enough, sufficiently
취미=hobby
취소=cancellation
취소하다=to cancel, call off
취업=employment, finding a job
취재=selection, picking out of news articles
취직=employment, getting a job
취하다=to adopt, assume, take
취향=taste, liking, one's inclinations
층=floor, grade, class
치과=a dentist
치다=to attack, assault
치료=medical treatment, medical care
치료법=a curative means
치료하다=to cure, heal, treat a patient
치르다=pay off, pay one's bill
치마=a skirt
치아=a tooth
치약=toothpaste
치우다=straighten up, tidy, remove
치즈=cheese
친구=a friend
친절=kindness, goodness
친절하다=to be kind, to be nice
친정=a woman's maiden home and family
친척=relatives
친하다=to be intimate, familiar, close, friendly
친해지다=to get close, to get friendly
칠=seven
칠십=seventy
칠월=month of July
칠판=the blackboard
칠하다=paint, coat
침=spit
침대=a bed
침묵=silence
침실=bedroom
침착하다=self-possession, composure
칫솔=a toothbrush
칭찬=admiration
칭찬하다=to praise somebody
카드=card
카레=curry
카메라=camera
카운터=counter, where you pay
카페=cafe
칸=blank space
칼=a knife
칼국수=knife-cut noodles
캄캄하다=to be pitch-black
캐나다=Canada
캐릭터=character
캠퍼스=campus
캠페인=campaign
커다랗다=to be very big
커지다=to become bigger
커튼=curtain
커피=coffee
컨디션=condition
컬러=color
컴퓨터=computer
컵=cup
케첩=ketchup
켜다=to light, turn on, kindle
켜지다=to become turned on
코=the nose
코끝=the tip of one's nose
코끼리=an elephant
코너=corner
코드=code
코미디=comedy
코스=course
코스모스=cosmos
코치=coach
코트=court
코피=a nose bleed
콘서트=concert
콜라=cola
콤플렉스=complex
콩=a bean
콩나물=bean soup
쾌감=a pleasant sensation, a good feeling
크기=size, dimensions
크다=to be big, large
크리스마스=Christmas
크림=cream
큰길=main road
큰딸=oldest daughter
큰소리=a loud voice, loudly
큰아들=oldest son
큰아버지=uncle older than one's father
큰어머니=the wife of the elder brother of one's father
큰일=an important affair, a serious matter
큰절=a deep bow
클래식=classic
클럽=club
키=stature, height
키스=kiss
키우다=to raise, bring up, rear
킬로=kilo
킬로그램=kilogram
킬로미터=kilometer
타고나다=be born, gifted with
타다=ride
타락=depravity, corruption, degradation
타오르다=blaze, light up
타입=type
타자기=a typewriter
탁=with a bang, with a snap
탁구=Ping-Pong, table tennis
탁월하다=be excellent
탁자=a table, desk
탄생=birth
탄생하다=to be born
탈출하다=to escape, get away from
탑=a tower
탓=fault, blame
태도=attitude, comportment
태아=a fetus, an unborn child
태양=the sun
태어나다=to be born, see the light of day
태우다=burn, commit to flames
태풍=typhoon
택시=taxi
택하다=choose, select
탤런트=talent
터=one's status, one's lot
터널=tunnel
터뜨리다=break, burst, explode
터미널=terminal
터지다=break, be torn, get away from
턱=the chin
털=hair; fur, feathers
털다=to shake off, brush up
텅=hollow
테니스=tennis
테러=terror
테스트=test
테이블=table
테이프=tape
텍스트=text
텔레비전=television
토끼=a rabbit
토대=a foundation, a base
토론=a debate, discussion
토론자=a debater, a disputant
토론하다=to debate, discuss
토론회=a debating society
토마토=tomato
토요일=Saturday
토하다=to vomit
톤=a ton
통=a tub, a cask
통계=statistics
통과=passage
통과하다=passage through
통로=a passage, a way, an aisle
통신=communications, correspondence
통역=interpreting
통일=unification
통일하다=to unify, consolidate
통장=a bankbook
통제=control, regulation
통증=an ache, pain
통하다=run, lead; flow; go through
통합=unity, unification
통화=conversation by telephone
퇴근=leaving one's office, coming home from work
퇴근하다=to go home from work
퇴원=leaving the hospital
퇴원하다=to leave the hospital
퇴직금=retirement grants
투명하다=to be transparent, clear
투자=investment
투표=vote, voting
튀기다=to fry; splash, splatter
튀김=batter-fried food
튀다=spring, bound, jump
튀어나오다=jump out, spring out
트럭=truck
트이다=get cleared out, open up
특급=in a special class
특별=be special, extraordinary
특별하다=to be special, extraordinary
특별히=especially
특성=a special characteristic
특수=characteristic, distinct, unique
특수성=particularity, distinctiveness
특이하다=be peculiar, special, unique
특정하다=specify
특징=a special feature, a distinguishing feature
특히=especially
튼튼하다=solid, compact, firm
튼튼히=strongly, firmly
틀=a frame, framework; mold
틀다=to twist, wind
틀리다=to be turned, warped
틀림없다=no mistaking it
틀림없이=no mistaking it
틈=a crack, gap, opening
티브이=TV
티셔츠=t-shirts
팀=team
파=onions
파괴하다=destruction, demolition
파다=to dig
파도=waves, billows
파란색=blue
파랗다=to be blue
파리=a fly
파악하다=grasp, seize, understand
파일=file
파출소=small, local police box
파티=party
판=a match, game, contest
판결=a judgment
판단=a judgment, a conclusion
판단하다=to make a conclusion
판매=sale, selling
판매되다=to be sold
판매하다=to sell
판사=a judge
팔=an arm
팔다=to sell
팔리다=to be in demand, to be sold
팔십=80
팔월=august
팝송=pop song
패션=fashion
팩=pack
팩스=fax
팩시밀리=fax
팬=pan
팬티=panties
퍼센트=percent
퍼지다=spread out, get broader
퍽=very, very much
페인트=paint
펴내다=publish, bring out in print
펴다=spread out, unfold
편=direction, way
편견=a prejudice, a bias
편리하다=to be convenient, handy
편안하다=to be peaceful
편의=convenience, expediency
편의점=convenient store
편지=letter
편하다=untroubled from cares
편히=easily, comfortably
펼쳐지다=stretch, extend away
평=a square area about 2 square meters
평가=evaluation, appraisal
평가되다=to be appraised
평가하다=to evaluate, estimate, judge
평균=average
평범하다=plain, average
평상시=normally
평생=a lifetime
평소=ordinary times, ordinarily
평양=capital of north Korea
평일=a weekday
평화=peace
평화롭다=to be peaceful
폐지=abolition, to not use, to do away with
포근하다=to be soft and comfortable, downy
포기하다=to give up, to abandon
포도=grape
포도주=grape wine
포스터=poster
포인트=point
포장=packing, wrapping
포장마차=a wheeled snack bar on the street
포크=fork
포함=inclusion, comprehension
포함되다=to be included in
포함하다=to include, contain
폭=width; range
폭넓다=to be broad
폭력=violent, brute force
표=a marker, indication
표면=front, surface, exterior
표시=a sign, signal
표시하다=to make a sign, display
표정=facial expression, look
표준=a standard, norm, criteria
표현=verbal expression, representation, manifestation
표현되다=to have been expressed
표현하다=to express, make known by saying
푸다=dip out, bail out
푸르다=to be blue, to be green
푹=completely, entirely
풀=grass
풀다=untie, loosen ; to melt into
풀리다=to come loose
풀어지다=to get loose; to turn soft
품=width; bosom, breast
품다=to hold, embrace
품목=the name of an article, a list of articles
품질=the quality of the article
풍경=landscape, scenery
풍부하다=to be abundant, copious, plentiful
풍속=manners, customs, morals
풍습=customs, manners, practices ; a ritual, rituals
프랑스=France
프로=professional
프로그램=program
프린터=printer
플라스틱=plastic
피=blood
피곤=fatigue, exhaustion
피곤하다=to be very tired, exhausted
피다=to bloom
피디=a newspaper article
피로=fatigue, exhaustion
피로하다=to be fatigued, weary
피망=a pimento
피부=skin
피시=pc, personal computer
피우다=to make, build, kindle
피자=pizza
피하다=avoid, keep away
피해=damage
피해자=a sufferer, the injured party
필름=film
필수=necessary, indispensable
필수적=necessary, indispensable
필연적=necessity, necessary
필요=need, requirement, necessity
필요성=necessity
필요하다=to need
필자=the writer, author
필통=pencil case
핑계=excuse
하=below, underneath
하긴=indeed, though, nevertheless
하나=one
하나님=god
하나하나=each individual piece
하느님=god
하늘=the sky
하다=to do
하도=too much, excessively
하드웨어=hardware
하루=a day
하룻밤=one night, a single night
하반기=the second half of the year
하숙집=dormitory, boarding house
하순=the final third of the month
하얀색=white
하얗다=white
하여튼=anyways
하지만=but, nevertheless
하천=a river, watercourse
하품=yawning
하필=why necessarily? why of all things?
학과=a department in a college
학교=school
학교생활=student
학급=a class
학기=an educational term
학년=a school year
학력=academic background, formal schooling
학번=year of graduation
학부모=mothers of the students
학비=tuition
학생=student
학생증=student identification
학술=science, learning
학습=learning, education
학용품=school things, supplies
학원=learning institute
학위=academic rank
학자=scholar
학점=a unit, a point, a credit
한=one, a single
한가운데=the very middle, the center
한가하다=to be free, not busy
한강=the Han river, runs through Seoul
한겨울=midwinter, the dead of winter
한결=stands out conspicuously, especially
한계=boundary, limits
한구석=a corner, a nook
한국=Korea
한국말=Korean language
한국어=Korean language
한국적=Korean
한글=Korean writing system
한글날=Korean writing system national holiday
한꺼번에=all at once
한낮=noon
한눈=a look, glimpse, look
한데=the open air, outside, the exterior
한동안=for quite a while
한두=one or two
한둘=one or two
한때=for a while, temporarily
한라산=Halla-san mountain
한마디=one word
한문=Chinese writing, Chinese classics
한반도=the Korean peninsula
한밤중=midnight
한번=once
한복=Korean traditional clothing
한순간=one fleeting moment
한숨=a breath
한식=Korean food
한여름=midsummer, the middle of summer
한자=Korean character, derived from Chinese
한잔=a drink of liquor
한잔하다=to drink a glass of liquor
한정되다=to be limited, qualified
한정하다=to limit, restrict
한쪽=on one side
한참=for some time, for a while
한창=the height, summit , the top
한층=more, still more
한편=one side, one way
한평생=a lifetime
한하다=limit, restrict
할머니=grandmother
할아버지=grandfather
할인=a discount
함께=together, with
함께하다=to do it together, with somebody
함부로=indiscriminately, at random
합격=success in an examination
합격하다=to pass an exam
합리적=rational, reasonable
합치다=combine, unite
합하다=harmonize with, be in accord with
항공=an airport
항공기=an aircraft
항구=a port, a harbor
항상=always
항의=a protest
해=a year
해결=solution, settlement
해결되다=to be settled, resolved
해결하다=to fix a problem, solve a question
해군=the navy
해내다=to accomplish, achieve, carry through
해답=a solution to a problem, an answer to a question
해당=fall under the purview of
해당되다=to be applied
해당하다=to be applied
해롭다=to be harmful, injurious
해마다=every year, each year
해물=marine products
해석=interpretation, a comment
해석하다=to interpret, construe
해설=explanation, elucidation
해소=dissolution, disorganization
해소하다=to be dissolved, disorganized
해수욕장=a swimming beach
해안=the seashore, the coast
해외=abroad, foreign countries
해외여행=foreign travel
핵=a nucleus, core
핵심=the kernel, the core
핸드백=handbag
핸드폰=cell phone
햄=ham
햄버거=hamburger
햇볕=sunbeams, sunlight
햇빛=sunshine, sunlight
햇살=the rays of the sun
행동=action, behavior
행동하다=to act, behave
행복=happiness
행복하다=to be happy
행사=an event, a function
행운=good luck, good fortune
행위=an act, deed, behavior
행하다=to do, act, behave
향=perfume, incense
향기=fragrance, aroma, perfume
향상=improve; elevation, rise
향상되다=to be improved, advanced
향수=a perfume
향하다=to face, look out on
허가=permission, grant, leave
허락=consent, assent, approval
허락하다=consent, agree to
허리=the waist, the small of the back
허용=permission, allowance
허용되다=to be permitted, approved
허용하다=to permit, approve, grant, allow
허허=ha-ha, with a laugh
헌=old, shabby, worn-out
헤매다=wander about, roam about
헤아리다=consider, weigh, ponder, consider
헤어지다=part from, part company with
헬기=helicopter
혀=the tongue
현=the present, the existence, actuality
현관=the porch, the entrance
현관문=the front door
현금=cash, ready funds, not a credit card
현대=the present age, times
현대인=a modern person
현대적=modern
현상=the present situation, state
현실=actuality, reality
현실적=down to earth, realistic
현장=on site, on location, at the site in question
현재=the present time, now, at present
현지=the actual place, the very spot
혈액=blood
협력=cooperation, cooperate with
형=an elder brother
형님=the respectful, proper way a man refers to an older friend
형부=a husband of a girl's older sister
형사=a criminal, penal case
형성=formation
형성되다=to be formed, made up
형성하다=to form, make, take shape
형수=the wife of one's older brother
형식=a form, formality, mold
형식적=related to the form
형제=brothers and sisters
형태=form, shape
형편=the situation, the state of things
혜택=a favor, benefit
호=a pen name, a title; a number, an issue
호기심=curiosity
호랑이=a tiger
호박=pumpkin
호선=the track number for a train
호수=a lake
호실=tells you the room number
호주=Australia
호주머니=a pocket
호텔=hotel
호흡=respiration, breath
혹시=sometimes
혹은=if that's not the case
혼나다=get frightened, scared
혼자=alone
혼잣말=talking to oneself
홀로=alone, by oneself
홈페이지=homepage
홍보=public information, public relations
홍수=a flood, inundation
홍차=tea, black tea
화=anger
화가=a painter, a drawer artist
화나다=get angry
화려하다=splendor, magnificence of a display, a look
화면=screen
화분=flower pot
화살=an arrow
화요일=Tuesday
화장=makeup
화장실=bathroom
화장지=soft paper used when applying makeup
화장품=makeup, cosmetics
화재=a fire, a blaze
화제=subject of conversation
화학=chemistry
확=with a burst, great puff
확대되다=to be magnified
확대하다=to enlarge, magnify
확립하다=establish, settle, fix
확보=security, insurance
확산되다=to get diffused
확신=conviction, firm belief
확신하다=to be confident of
확실하다=to be sure, certain
확실히=certainly, for sure
확인=a check, confirmation
확인되다=to be confirmed
확인하다=to confirm, corroborate
확장=expansion, enlargement
확정=decision, settlement
환갑=one's 60th anniversary
환경=environment
환경오염=environmental pollution
환영=welcome
환영하다=to welcome
환율=the exchange rate
환자=a patient
환하다=to be clear, unobstructed ; to be light, bright
활기=vigor, life, vitality
활동=activity
활동하다=to be active, lead an active life
활발하다=be lively, sprightly
활발해지다=to become lively
활발히=briskly, actively
활용=practical use
활용하다=utilize, make practical use of
활짝=extensively, widely
회=a time, an inning, a round in a game
회견=an interview, a meeting
회관=an assembly hall
회복=recovery, recuperation
회복되다=to be recovered
회복하다=to recover, get better, get well again
회사=a company
회색=gray
회원=a member of a society
회의=a meeting, a conference
회장=chairman, the president
회전=revolution, rotation
회화=conversations, talk
횟수=the number of times, the frequency
횡단보도=crossing
효과=effect, effectiveness
효과적=effective
효도=filial piety
효도하다=to be a good son to one's parents
효율적=the utility factor, efficiency
효자=a dutiful son
후=after
후기=the latter term
후반=the latter half
후배=one's junior
후보=candidature, candidacy
후춧가루=ground pepper
후회=repentance, regret
후회하다=to regret
훈련=training
훌륭하다=to be excellent
훔치다=to steal
훨씬=by far, very much so
휴가=holidays, vacation
휴식=rest, take a rest
휴일=a day off of work, a holiday
휴지=toilet paper
휴지통=waste paper basket
흉내=imitation, mimicry
흐려지다=get cloudy, overcast
흐르다=flow, stream
흐름=flowing, a stream
흐리다=cloudy
흑백=black and white
흑인=a negro
흔들다=shake, sway
흔들리다=shake, swing, rock, tremble
흔적=traces, signs, evidences
흔하다=to be everywhere
흔히=generally, commonly ; often
흘러가다=flow, run, drift along
흘러나오다=flow out, run, effuse
흘러내리다=run down
흘리다=spill, shed
흙=earth, the soil
흥미=interest, zeal
흥미롭다=to be interesting
흥분=excitement, excitation
흥분하다=be excited
흩어지다=scatter about
희곡=a drama, a play
희다=white, fair
희망=hope, wish
희망하다=hope
희생=a sacrifice
희생하다=to sacrifice
흰색=gray, ash color
힘=power
힘겹다=to be not strong enough to do
힘껏=with all one's might
힘들다=to be hard, difficult
힘들어하다=to be exacting, tolling
힘쓰다=to try really hard
힘없이=feebly, weekly
힘차다=be forcible, powerful
